variant,token,missing,substituted,total_errors,error_rate
whisper-small,the,2317,6155,8472,1.0
whisper-large-v3-turbo,the,1895,5272,7167,1.0
GPT-4o mini Transcribe,the,1557,4553,6110,1.0
whisper-small,of,1206,3985,5191,1.0
whisper-small,to,1172,3649,4821,1.0
whisper-large-v3-turbo,of,993,3364,4357,1.0
whisper-small,in,1017,3215,4232,1.0
whisper-large-v3-turbo,to,1005,3177,4182,1.0
whisper-small,and,976,2889,3865,1.0
GPT-4o mini Transcribe,of,819,2966,3785,1.0
whisper-large-v3-turbo,in,767,2907,3674,1.0
GPT-4o mini Transcribe,to,810,2742,3552,1.0
whisper-large-v3-turbo,and,836,2559,3395,1.0
GPT-4o mini Transcribe,in,650,2515,3165,1.0
GPT-4o mini Transcribe,and,612,2431,3043,1.0
whisper-small,we,866,1973,2839,1.0
whisper-small,a,658,1836,2494,1.0
whisper-large-v3-turbo,we,750,1662,2412,1.0
whisper-large-v3-turbo,a,502,1649,2151,1.0
whisper-small,million,260,1864,2124,1.0
GPT-4o mini Transcribe,we,625,1435,2060,1.0
whisper-small,is,593,1387,1980,1.0
GPT-4o mini Transcribe,a,437,1509,1946,1.0
whisper-small,for,435,1419,1854,1.0
whisper-small,you,617,1053,1670,1.0
whisper-small,that,548,1102,1650,1.0
whisper-large-v3-turbo,million,199,1448,1647,1.0
whisper-large-v3-turbo,is,468,1166,1634,1.0
whisper-large-v3-turbo,for,352,1222,1574,1.0
whisper-small,year,301,1264,1565,1.0
whisper-small,our,326,1097,1423,1.0
whisper-large-v3-turbo,you,495,916,1411,1.0
GPT-4o mini Transcribe,million,214,1179,1393,1.0
whisper-large-v3-turbo,that,461,927,1388,1.0
whisper-small,quarter,206,1181,1387,1.0
whisper-small,on,426,957,1383,1.0
whisper-large-v3-turbo,year,300,1014,1314,1.0
GPT-4o mini Transcribe,year,249,1054,1303,1.0
GPT-4o mini Transcribe,is,393,890,1283,1.0
GPT-4o mini Transcribe,that,438,814,1252,1.0
GPT-4o mini Transcribe,for,279,968,1247,1.0
whisper-small,at,264,930,1194,1.0
GPT-4o mini Transcribe,you,379,788,1167,1.0
whisper-large-v3-turbo,our,288,873,1161,1.0
whisper-large-v3-turbo,quarter,147,980,1127,1.0
whisper-small,this,305,799,1104,1.0
whisper-small,so,393,702,1095,1.0
whisper-large-v3-turbo,on,354,736,1090,1.0
GPT-4o mini Transcribe,quarter,163,904,1067,1.0
whisper-small,billion,179,855,1034,1.0
GPT-4o mini Transcribe,our,211,779,990,1.0
whisper-large-v3-turbo,at,178,799,977,1.0
whisper-small,with,217,755,972,1.0
whisper-small,as,282,650,932,1.0
GPT-4o mini Transcribe,on,267,660,927,1.0
whisper-small,i,390,533,923,1.0
whisper-large-v3-turbo,so,267,656,923,1.0
whisper-large-v3-turbo,billion,128,774,902,1.0
whisper-small,have,258,633,891,1.0
whisper-small,by,167,723,890,1.0
whisper-small,from,200,656,856,1.0
whisper-large-v3-turbo,this,202,651,853,1.0
GPT-4o mini Transcribe,at,128,718,846,1.0
GPT-4o mini Transcribe,billion,134,711,845,1.0
whisper-large-v3-turbo,as,269,570,839,1.0
whisper-large-v3-turbo,with,188,646,834,1.0
whisper-small,was,246,580,826,1.0
GPT-4o mini Transcribe,this,210,597,807,1.0
GPT-4o mini Transcribe,so,249,514,763,1.0
GPT-4o mini Transcribe,with,146,612,758,1.0
whisper-large-v3-turbo,from,215,541,756,1.0
whisper-large-v3-turbo,by,152,581,733,1.0
whisper-large-v3-turbo,was,158,565,723,1.0
whisper-small,are,252,469,721,1.0
whisper-large-v3-turbo,i,255,466,721,1.0
whisper-small,per,73,626,699,1.0
whisper-large-v3-turbo,have,218,476,694,1.0
GPT-4o mini Transcribe,by,139,553,692,1.0
GPT-4o mini Transcribe,as,202,464,666,1.0
whisper-small,it,213,438,651,1.0
GPT-4o mini Transcribe,from,198,451,649,1.0
GPT-4o mini Transcribe,was,162,465,627,1.0
GPT-4o mini Transcribe,i,203,408,611,1.0
GPT-4o mini Transcribe,have,166,434,600,1.0
whisper-large-v3-turbo,are,197,399,596,1.0
whisper-small,be,159,433,592,1.0
whisper-large-v3-turbo,per,61,530,591,1.0
GPT-4o mini Transcribe,per,54,530,584,1.0
whisper-small,about,152,426,578,1.0
whisper-small,which,152,393,545,1.0
whisper-small,an,70,464,534,1.0
GPT-4o mini Transcribe,are,162,361,523,1.0
whisper-small,were,109,406,515,1.0
whisper-large-v3-turbo,it,193,318,511,1.0
whisper-large-v3-turbo,about,129,380,509,1.0
whisper-small,or,136,366,502,1.0
whisper-large-v3-turbo,which,123,372,495,1.0
whisper-small,will,118,375,493,1.0
whisper-small,its,163,328,491,1.0
whisper-large-v3-turbo,be,120,368,488,1.0
whisper-small,last,111,372,483,1.0
whisper-small,pre,168,314,482,1.0
whisper-small,first,189,292,481,1.0
whisper-large-v3-turbo,will,119,356,475,1.0
whisper-large-v3-turbo,were,109,355,464,1.0
GPT-4o mini Transcribe,about,111,343,454,1.0
GPT-4o mini Transcribe,be,95,357,452,1.0
whisper-large-v3-turbo,an,81,371,452,1.0
whisper-small,up,103,343,446,1.0
whisper-small,increase,73,363,436,1.0
GPT-4o mini Transcribe,it,147,288,435,1.0
whisper-small,around,59,375,434,1.0
GPT-4o mini Transcribe,which,100,329,429,1.0
GPT-4o mini Transcribe,were,72,356,428,1.0
whisper-small,know,171,254,425,1.0
whisper-small,compared,50,369,419,1.0
whisper-small,growth,98,320,418,1.0
whisper-large-v3-turbo,cents,6,410,416,1.0
whisper-large-v3-turbo,know,186,228,414,1.0
whisper-small,over,117,296,413,1.0
whisper-large-v3-turbo,pre,151,259,410,1.0
whisper-large-v3-turbo,first,123,284,407,1.0
whisper-small,net,55,348,403,1.0
GPT-4o mini Transcribe,will,104,297,401,1.0
whisper-small,now,120,279,399,1.0
whisper-large-v3-turbo,last,85,313,398,1.0
GPT-4o mini Transcribe,last,79,317,396,1.0
whisper-large-v3-turbo,compared,41,352,393,1.0
GPT-4o mini Transcribe,cents,0,392,392,1.0
whisper-small,but,128,263,391,1.0
whisper-small,third,45,342,387,1.0
GPT-4o mini Transcribe,compared,45,340,385,1.0
GPT-4o mini Transcribe,first,118,262,380,1.0
whisper-large-v3-turbo,or,112,265,377,1.0
GPT-4o mini Transcribe,or,74,303,377,1.0
whisper-large-v3-turbo,increase,50,324,374,1.0
whisper-large-v3-turbo,its,132,238,370,1.0
whisper-small,us,58,311,369,1.0
whisper-small,share,23,344,367,1.0
whisper-small,cash,42,320,362,1.0
GPT-4o mini Transcribe,share,27,333,360,1.0
whisper-large-v3-turbo,net,41,317,358,1.0
GPT-4o mini Transcribe,an,45,310,355,1.0
whisper-large-v3-turbo,around,44,308,352,1.0
whisper-small,thats,100,252,352,1.0
whisper-large-v3-turbo,share,15,332,347,1.0
whisper-small,just,126,214,340,1.0
whisper-large-v3-turbo,now,87,249,336,1.0
whisper-small,very,111,224,335,1.0
whisper-small,think,104,231,335,1.0
GPT-4o mini Transcribe,know,114,220,334,1.0
whisper-large-v3-turbo,but,101,233,334,1.0
whisper-large-v3-turbo,us,45,286,331,1.0
GPT-4o mini Transcribe,pre,93,235,328,1.0
GPT-4o mini Transcribe,net,48,277,325,1.0
whisper-small,cents,8,316,324,1.0
GPT-4o mini Transcribe,around,28,293,321,1.0
GPT-4o mini Transcribe,increase,56,263,319,1.0
whisper-small,what,93,224,317,1.0
whisper-large-v3-turbo,up,85,232,317,1.0
whisper-small,total,39,270,309,1.0
whisper-small,can,93,216,309,1.0
whisper-large-v3-turbo,growth,83,224,307,1.0
whisper-small,more,67,237,304,1.0
whisper-small,months,80,223,303,1.0
GPT-4o mini Transcribe,over,62,241,303,1.0
whisper-large-v3-turbo,than,95,205,300,1.0
whisper-large-v3-turbo,over,74,226,300,1.0
whisper-small,than,73,226,299,1.0
whisper-large-v3-turbo,third,47,250,297,1.0
GPT-4o mini Transcribe,now,84,212,296,1.0
whisper-small,end,68,226,294,1.0
GPT-4o mini Transcribe,up,63,227,290,1.0
whisper-small,expect,52,233,285,1.0
GPT-4o mini Transcribe,than,61,221,282,1.0
whisper-large-v3-turbo,very,88,192,280,1.0
whisper-large-v3-turbo,what,85,192,277,1.0
whisper-small,has,55,221,276,1.0
whisper-small,your,138,136,274,1.0
whisper-small,thank,107,167,274,1.0
whisper-small,ebitda,24,250,274,1.0
GPT-4o mini Transcribe,think,61,210,271,1.0
whisper-large-v3-turbo,thats,74,196,270,1.0
whisper-small,question,158,112,270,1.0
whisper-small,second,55,213,268,1.0
whisper-large-v3-turbo,think,50,218,268,1.0
GPT-4o mini Transcribe,but,82,183,265,1.0
whisper-small,well,88,177,265,1.0
whisper-small,if,103,162,265,1.0
whisper-large-v3-turbo,total,46,219,265,1.0
whisper-small,would,92,172,264,1.0
GPT-4o mini Transcribe,its,70,194,264,1.0
whisper-small,been,63,198,261,1.0
whisper-small,sales,59,202,261,1.0
GPT-4o mini Transcribe,half,21,238,259,1.0
GPT-4o mini Transcribe,third,38,221,259,1.0
whisper-small,also,63,192,255,1.0
GPT-4o mini Transcribe,growth,50,204,254,1.0
whisper-small,not,104,149,253,1.0
whisper-small,like,94,159,253,1.0
GPT-4o mini Transcribe,more,57,195,252,1.0
GPT-4o mini Transcribe,thats,54,198,252,1.0
whisper-large-v3-turbo,cash,46,204,250,1.0
whisper-large-v3-turbo,more,74,173,247,1.0
whisper-large-v3-turbo,if,97,144,241,1.0
GPT-4o mini Transcribe,cash,22,219,241,1.0
whisper-small,margin,26,213,239,1.0
whisper-large-v3-turbo,sales,51,186,237,1.0
whisper-large-v3-turbo,second,34,203,237,1.0
whisper-small,all,44,192,236,1.0
whisper-small,income,15,219,234,1.0
whisper-large-v3-turbo,also,58,176,234,1.0
whisper-large-v3-turbo,just,94,140,234,1.0
whisper-small,years,93,141,234,1.0
whisper-large-v3-turbo,has,51,182,233,1.0
whisper-large-v3-turbo,end,41,192,233,1.0
whisper-large-v3-turbo,income,18,215,233,1.0
GPT-4o mini Transcribe,very,59,173,232,1.0
GPT-4o mini Transcribe,total,31,200,231,1.0
whisper-small,next,84,145,229,1.0
whisper-large-v3-turbo,half,19,209,228,1.0
GPT-4o mini Transcribe,has,53,175,228,1.0
GPT-4o mini Transcribe,also,52,176,228,1.0
whisper-large-v3-turbo,expect,44,183,227,1.0
whisper-small,see,74,153,227,1.0
whisper-large-v3-turbo,can,67,159,226,1.0
whisper-large-v3-turbo,months,70,156,226,1.0
whisper-small,there,100,124,224,1.0
whisper-small,revenue,34,189,223,1.0
whisper-small,then,66,157,223,1.0
whisper-small,business,66,157,223,1.0
GPT-4o mini Transcribe,second,36,186,222,1.0
whisper-large-v3-turbo,see,59,160,219,1.0
GPT-4o mini Transcribe,income,22,196,218,1.0
whisper-large-v3-turbo,all,34,181,215,1.0
whisper-large-v3-turbo,going,76,138,214,1.0
whisper-small,going,78,135,213,1.0
GPT-4o mini Transcribe,sales,38,174,212,1.0
whisper-small,had,64,148,212,1.0
whisper-large-v3-turbo,would,68,144,212,1.0
whisper-small,slide,83,127,210,1.0
whisper-small,increased,28,182,210,1.0
GPT-4o mini Transcribe,us,26,184,210,1.0
whisper-small,basis,25,184,209,1.0
whisper-large-v3-turbo,like,78,131,209,1.0
GPT-4o mini Transcribe,months,56,153,209,1.0
whisper-small,yen,27,180,207,1.0
whisper-small,half,45,162,207,1.0
whisper-large-v3-turbo,point,25,182,207,1.0
whisper-large-v3-turbo,question,134,71,205,1.0
whisper-small,point,22,183,205,1.0
whisper-large-v3-turbo,then,73,132,205,1.0
whisper-large-v3-turbo,well,64,140,204,1.0
whisper-small,these,55,148,203,1.0
whisper-large-v3-turbo,not,55,146,201,1.0
whisper-small,when,49,152,201,1.0
whisper-large-v3-turbo,yen,18,183,201,1.0
GPT-4o mini Transcribe,yen,21,180,201,1.0
whisper-large-v3-turbo,business,72,127,199,1.0
GPT-4o mini Transcribe,can,73,122,195,1.0
whisper-small,euros,24,170,194,1.0
whisper-large-v3-turbo,ebitda,19,175,194,1.0
whisper-small,during,49,144,193,1.0
whisper-large-v3-turbo,your,91,102,193,1.0
GPT-4o mini Transcribe,not,60,132,192,1.0
whisper-small,range,26,165,191,1.0
whisper-large-v3-turbo,been,29,162,191,1.0
whisper-small,period,31,160,191,1.0
whisper-small,market,65,126,191,1.0
whisper-large-v3-turbo,had,68,121,189,1.0
whisper-large-v3-turbo,thank,67,122,189,1.0
whisper-large-v3-turbo,years,63,125,188,1.0
GPT-4o mini Transcribe,revenue,13,174,187,1.0
whisper-small,guidance,46,141,187,1.0
whisper-small,dividend,51,136,187,1.0
whisper-small,number,58,128,186,1.0
GPT-4o mini Transcribe,just,77,109,186,1.0
GPT-4o mini Transcribe,what,58,127,185,1.0
whisper-small,cost,34,149,183,1.0
GPT-4o mini Transcribe,had,59,123,182,1.0
whisper-small,strong,60,122,182,1.0
GPT-4o mini Transcribe,like,53,128,181,1.0
whisper-small,right,77,104,181,1.0
whisper-large-v3-turbo,guidance,29,152,181,1.0
GPT-4o mini Transcribe,see,44,135,179,1.0
whisper-large-v3-turbo,during,43,134,177,1.0
whisper-small,please,97,80,177,1.0
whisper-small,capital,33,143,176,1.0
whisper-large-v3-turbo,margin,19,155,174,1.0
whisper-large-v3-turbo,cost,31,143,174,1.0
whisper-small,terms,74,100,174,1.0
GPT-4o mini Transcribe,then,54,119,173,1.0
whisper-small,q3,40,132,172,1.0
GPT-4o mini Transcribe,expect,26,146,172,1.0
whisper-small,rate,28,144,172,1.0
GPT-4o mini Transcribe,margin,21,150,171,1.0
whisper-large-v3-turbo,there,80,91,171,1.0
GPT-4o mini Transcribe,would,33,138,171,1.0
GPT-4o mini Transcribe,if,47,123,170,1.0
whisper-large-v3-turbo,range,25,145,170,1.0
GPT-4o mini Transcribe,been,29,141,170,1.0
whisper-small,okay,53,116,169,1.0
GPT-4o mini Transcribe,thank,38,130,168,1.0
whisper-large-v3-turbo,next,67,101,168,1.0
whisper-small,weve,70,98,168,1.0
whisper-large-v3-turbo,points,32,136,168,1.0
whisper-large-v3-turbo,euros,3,163,166,1.0
GPT-4o mini Transcribe,years,63,102,165,1.0
whisper-large-v3-turbo,new,57,108,165,1.0
whisper-large-v3-turbo,when,53,112,165,1.0
whisper-small,new,48,116,164,1.0
whisper-small,yeah,56,107,163,1.0
whisper-small,good,85,78,163,1.0
whisper-large-v3-turbo,revenue,16,147,163,1.0
whisper-small,out,28,134,162,1.0
whisper-large-v3-turbo,period,29,132,161,1.0
GPT-4o mini Transcribe,all,16,145,161,1.0
whisper-large-v3-turbo,higher,26,134,160,1.0
GPT-4o mini Transcribe,business,46,114,160,1.0
whisper-small,higher,32,128,160,1.0
whisper-large-v3-turbo,basis,27,133,160,1.0
whisper-small,euro,21,138,159,1.0
GPT-4o mini Transcribe,going,66,93,159,1.0
GPT-4o mini Transcribe,point,18,140,158,1.0
GPT-4o mini Transcribe,next,57,101,158,1.0
whisper-small,points,27,131,158,1.0
GPT-4o mini Transcribe,end,37,120,157,1.0
whisper-small,because,48,109,157,1.0
whisper-small,some,46,111,157,1.0
whisper-small,operating,19,138,157,1.0
whisper-small,fourth,11,145,156,1.0
GPT-4o mini Transcribe,increased,16,139,155,1.0
whisper-small,price,30,125,155,1.0
whisper-large-v3-turbo,increased,24,131,155,1.0
whisper-small,positive,22,133,155,1.0
whisper-large-v3-turbo,adjusted,4,150,154,1.0
whisper-small,down,56,97,153,1.0
whisper-large-v3-turbo,some,39,114,153,1.0
GPT-4o mini Transcribe,ebitda,18,135,153,1.0
whisper-large-v3-turbo,capital,20,132,152,1.0
whisper-large-v3-turbo,operating,30,120,150,1.0
whisper-small,same,33,117,150,1.0
whisper-small,revenues,22,128,150,1.0
whisper-large-v3-turbo,weve,62,87,149,1.0
GPT-4o mini Transcribe,period,34,115,149,1.0
whisper-large-v3-turbo,market,59,88,147,1.0
whisper-small,those,53,94,147,1.0
whisper-small,trillion,3,143,146,1.0
whisper-large-v3-turbo,good,62,84,146,1.0
GPT-4o mini Transcribe,during,43,103,146,1.0
GPT-4o mini Transcribe,well,61,85,146,1.0
GPT-4o mini Transcribe,question,72,74,146,1.0
whisper-small,level,46,99,145,1.0
GPT-4o mini Transcribe,trillion,7,137,144,1.0
whisper-large-v3-turbo,day,8,136,144,1.0
whisper-small,performance,37,106,143,1.0
GPT-4o mini Transcribe,cost,22,121,143,1.0
GPT-4o mini Transcribe,market,47,96,143,1.0
whisper-large-v3-turbo,because,45,97,142,1.0
whisper-small,much,45,97,142,1.0
whisper-small,time,44,98,142,1.0
whisper-large-v3-turbo,lower,34,108,142,1.0
whisper-large-v3-turbo,please,86,56,142,1.0
whisper-large-v3-turbo,versus,21,120,141,1.0
GPT-4o mini Transcribe,euro,21,120,141,1.0
whisper-large-v3-turbo,euro,12,129,141,1.0
whisper-small,adjusted,7,133,140,1.0
GPT-4o mini Transcribe,dividend,21,118,139,1.0
whisper-small,flow,1,137,138,1.0
whisper-small,say,39,98,137,1.0
whisper-large-v3-turbo,trillion,11,126,137,1.0
whisper-large-v3-turbo,out,49,87,136,1.0
GPT-4o mini Transcribe,weve,50,86,136,1.0
whisper-small,into,22,114,136,1.0
whisper-small,call,49,86,135,1.0
whisper-large-v3-turbo,dividend,24,111,135,1.0
whisper-small,dollar,5,130,135,1.0
GPT-4o mini Transcribe,please,95,40,135,1.0
whisper-small,day,13,121,134,1.0
GPT-4o mini Transcribe,euros,3,131,134,1.0
whisper-small,do,50,84,134,1.0
whisper-large-v3-turbo,terms,45,89,134,1.0
GPT-4o mini Transcribe,points,23,111,134,1.0
whisper-small,results,40,93,133,1.0
whisper-large-v3-turbo,q3,23,110,133,1.0
GPT-4o mini Transcribe,out,18,115,133,1.0
GPT-4o mini Transcribe,there,83,50,133,1.0
whisper-small,production,39,94,133,1.0
GPT-4o mini Transcribe,new,51,81,132,1.0
GPT-4o mini Transcribe,capital,19,113,132,1.0
whisper-large-v3-turbo,same,22,110,132,1.0
GPT-4o mini Transcribe,earnings,21,110,131,1.0
whisper-small,go,38,93,131,1.0
GPT-4o mini Transcribe,when,39,92,131,1.0
whisper-large-v3-turbo,price,26,105,131,1.0
whisper-large-v3-turbo,dollar,5,125,130,1.0
whisper-small,should,42,87,129,1.0
whisper-small,lower,30,99,129,1.0
GPT-4o mini Transcribe,revenues,19,110,129,1.0
whisper-large-v3-turbo,much,38,90,128,1.0
GPT-4o mini Transcribe,higher,20,108,128,1.0
whisper-small,where,23,104,127,1.0
whisper-small,expenses,0,127,127,1.0
whisper-small,average,24,103,127,1.0
whisper-large-v3-turbo,okay,17,110,127,1.0
whisper-small,questions,96,31,127,1.0
whisper-small,earnings,15,112,127,1.0
whisper-small,still,35,92,127,1.0
GPT-4o mini Transcribe,operating,25,101,126,1.0
whisper-large-v3-turbo,yeah,38,88,126,1.0
GPT-4o mini Transcribe,basis,29,97,126,1.0
whisper-large-v3-turbo,rate,22,104,126,1.0
whisper-large-v3-turbo,slide,56,70,126,1.0
whisper-large-v3-turbo,right,44,82,126,1.0
whisper-small,again,30,96,126,1.0
whisper-large-v3-turbo,down,26,100,126,1.0
whisper-small,close,25,101,126,1.0
GPT-4o mini Transcribe,because,21,104,125,1.0
whisper-small,actually,33,92,125,1.0
GPT-4o mini Transcribe,range,19,105,124,1.0
whisper-small,grew,12,112,124,1.0
whisper-small,approximately,13,111,124,1.0
whisper-small,dollars,18,105,123,1.0
whisper-large-v3-turbo,these,27,96,123,1.0
whisper-small,due,29,94,123,1.0
whisper-large-v3-turbo,positive,18,104,122,1.0
whisper-large-v3-turbo,strong,36,86,122,1.0
whisper-large-v3-turbo,earnings,21,101,122,1.0
whisper-large-v3-turbo,production,45,76,121,1.0
GPT-4o mini Transcribe,good,40,81,121,1.0
whisper-large-v3-turbo,do,38,83,121,1.0
whisper-large-v3-turbo,due,28,93,121,1.0
whisper-large-v3-turbo,go,25,96,121,1.0
GPT-4o mini Transcribe,price,17,103,120,1.0
whisper-large-v3-turbo,into,38,82,120,1.0
whisper-small,versus,27,93,120,1.0
whisper-large-v3-turbo,close,23,96,119,1.0
whisper-large-v3-turbo,those,47,72,119,1.0
whisper-small,expected,20,97,117,1.0
GPT-4o mini Transcribe,guidance,30,87,117,1.0
whisper-large-v3-turbo,dollars,26,91,117,1.0
GPT-4o mini Transcribe,same,20,97,117,1.0
whisper-small,look,46,70,116,1.0
whisper-small,no,44,72,116,1.0
GPT-4o mini Transcribe,dollars,15,100,115,1.0
GPT-4o mini Transcribe,these,21,94,115,1.0
whisper-small,under,14,101,115,1.0
whisper-small,back,40,75,115,1.0
whisper-large-v3-turbo,expenses,19,96,115,1.0
whisper-small,crores,21,93,114,1.0
whisper-small,high,26,87,113,1.0
GPT-4o mini Transcribe,your,62,50,112,1.0
whisper-large-v3-turbo,approximately,19,92,111,1.0
GPT-4o mini Transcribe,versus,12,99,111,1.0
whisper-large-v3-turbo,revenues,24,87,111,1.0
whisper-small,q1,12,99,111,1.0
whisper-large-v3-turbo,look,44,67,111,1.0
whisper-small,today,24,87,111,1.0
GPT-4o mini Transcribe,right,44,67,111,1.0
whisper-small,could,60,50,110,1.0
whisper-small,maybe,35,75,110,1.0
GPT-4o mini Transcribe,yeah,55,55,110,1.0
whisper-small,they,21,89,110,1.0
GPT-4o mini Transcribe,those,44,66,110,1.0
whisper-large-v3-turbo,they,28,81,109,1.0
whisper-small,result,16,93,109,1.0
whisper-small,lets,29,80,109,1.0
whisper-small,little,33,76,109,1.0
whisper-small,december,25,83,108,1.0
GPT-4o mini Transcribe,day,11,97,108,1.0
whisper-small,between,26,82,108,1.0
whisper-large-v3-turbo,fiscal,21,87,108,1.0
whisper-small,plus,33,74,107,1.0
whisper-small,sorry,46,60,106,1.0
whisper-small,mentioned,39,67,106,1.0
whisper-large-v3-turbo,between,29,77,106,1.0
whisper-small,how,27,79,106,1.0
whisper-large-v3-turbo,number,24,82,106,1.0
whisper-small,fiscal,14,92,106,1.0
whisper-large-v3-turbo,back,23,83,106,1.0
whisper-small,here,38,67,105,1.0
whisper-small,capex,22,82,104,1.0
GPT-4o mini Transcribe,sorry,41,63,104,1.0
whisper-small,said,42,62,104,1.0
GPT-4o mini Transcribe,terms,33,71,104,1.0
GPT-4o mini Transcribe,level,24,80,104,1.0
whisper-large-v3-turbo,high,40,63,103,1.0
GPT-4o mini Transcribe,adjusted,0,103,103,1.0
whisper-large-v3-turbo,level,30,73,103,1.0
GPT-4o mini Transcribe,due,20,83,103,1.0
GPT-4o mini Transcribe,strong,30,72,102,1.0
GPT-4o mini Transcribe,lower,12,90,102,1.0
whisper-small,any,40,62,102,1.0
whisper-large-v3-turbo,obviously,19,83,102,1.0
GPT-4o mini Transcribe,into,26,76,102,1.0
whisper-small,even,23,78,101,1.0
whisper-large-v3-turbo,no,52,49,101,1.0
whisper-small,overall,29,72,101,1.0
GPT-4o mini Transcribe,plus,6,95,101,1.0
GPT-4o mini Transcribe,close,10,91,101,1.0
whisper-large-v3-turbo,could,41,60,101,1.0
whisper-large-v3-turbo,results,43,57,100,1.0
whisper-small,gross,22,78,100,1.0
GPT-4o mini Transcribe,dollar,1,99,100,1.0
GPT-4o mini Transcribe,do,35,65,100,1.0
GPT-4o mini Transcribe,say,24,75,99,1.0
whisper-small,term,29,70,99,1.0
whisper-small,forecast,6,92,98,1.0
whisper-large-v3-turbo,today,27,71,98,1.0
GPT-4o mini Transcribe,december,26,72,98,1.0
whisper-large-v3-turbo,flow,6,92,98,1.0
whisper-small,thanks,48,50,98,1.0
whisper-large-v3-turbo,where,19,79,98,1.0
GPT-4o mini Transcribe,much,22,75,97,1.0
whisper-small,after,17,80,97,1.0
whisper-large-v3-turbo,still,29,68,97,1.0
whisper-large-v3-turbo,questions,60,37,97,1.0
GPT-4o mini Transcribe,performance,31,65,96,1.0
whisper-small,obviously,38,58,96,1.0
whisper-large-v3-turbo,expected,15,81,96,1.0
whisper-small,financial,20,76,96,1.0
whisper-large-v3-turbo,overall,19,77,96,1.0
whisper-small,target,15,81,96,1.0
whisper-large-v3-turbo,decrease,19,76,95,1.0
whisper-large-v3-turbo,performance,25,70,95,1.0
GPT-4o mini Transcribe,some,27,68,95,1.0
whisper-small,significant,24,71,95,1.0
whisper-large-v3-turbo,lets,33,62,95,1.0
GPT-4o mini Transcribe,production,30,64,94,1.0
whisper-large-v3-turbo,maybe,25,69,94,1.0
whisper-small,vious,12,82,94,1.0
whisper-large-v3-turbo,how,15,79,94,1.0
whisper-large-v3-turbo,should,29,64,93,1.0
whisper-large-v3-turbo,time,31,62,93,1.0
whisper-small,tax,13,80,93,1.0
whisper-small,value,7,86,93,1.0
whisper-small,equivalent,9,84,93,1.0
whisper-small,times,23,70,93,1.0
GPT-4o mini Transcribe,approximately,10,82,92,1.0
whisper-large-v3-turbo,under,10,82,92,1.0
whisper-large-v3-turbo,forecast,9,83,92,1.0
whisper-small,line,37,55,92,1.0
GPT-4o mini Transcribe,number,18,74,92,1.0
GPT-4o mini Transcribe,today,23,68,91,1.0
GPT-4o mini Transcribe,time,35,56,91,1.0
GPT-4o mini Transcribe,positive,11,80,91,1.0
whisper-large-v3-turbo,fourth,6,85,91,1.0
whisper-small,already,33,58,91,1.0
whisper-large-v3-turbo,significant,30,61,91,1.0
whisper-large-v3-turbo,actually,18,73,91,1.0
GPT-4o mini Transcribe,tons,9,82,91,1.0
GPT-4o mini Transcribe,down,14,77,91,1.0
whisper-small,continue,23,68,91,1.0
whisper-large-v3-turbo,line,30,60,90,1.0
GPT-4o mini Transcribe,tax,1,89,90,1.0
GPT-4o mini Transcribe,rate,9,81,90,1.0
whisper-small,above,19,71,90,1.0
GPT-4o mini Transcribe,slide,25,64,89,1.0
whisper-small,impact,43,46,89,1.0
GPT-4o mini Transcribe,look,24,65,89,1.0
GPT-4o mini Transcribe,results,33,56,89,1.0
GPT-4o mini Transcribe,full,18,71,89,1.0
whisper-large-v3-turbo,say,23,66,89,1.0
GPT-4o mini Transcribe,fourth,17,72,89,1.0
whisper-large-v3-turbo,vious,12,76,88,1.0
whisper-large-v3-turbo,december,17,71,88,1.0
whisper-small,tons,22,66,88,1.0
GPT-4o mini Transcribe,flow,1,87,88,1.0
GPT-4o mini Transcribe,forecast,12,76,88,1.0
whisper-small,decreased,6,82,88,1.0
whisper-large-v3-turbo,continue,30,58,88,1.0
whisper-small,me,50,38,88,1.0
whisper-small,through,12,75,87,1.0
whisper-small,below,18,69,87,1.0
whisper-large-v3-turbo,q1,24,63,87,1.0
whisper-small,customers,22,65,87,1.0
whisper-small,september,18,69,87,1.0
GPT-4o mini Transcribe,again,17,70,87,1.0
GPT-4o mini Transcribe,vious,12,75,87,1.0
whisper-small,position,19,68,87,1.0
whisper-small,im,52,34,86,1.0
whisper-large-v3-turbo,capacity,35,51,86,1.0
whisper-large-v3-turbo,call,50,36,86,1.0
whisper-large-v3-turbo,tax,4,82,86,1.0
whisper-large-v3-turbo,average,19,67,86,1.0
whisper-small,take,48,38,86,1.0
whisper-small,my,53,33,86,1.0
whisper-small,moving,26,60,86,1.0
whisper-small,less,28,58,86,1.0
whisper-large-v3-turbo,impact,26,60,86,1.0
whisper-small,related,20,66,86,1.0
whisper-small,before,31,54,85,1.0
GPT-4o mini Transcribe,expenses,4,81,85,1.0
whisper-small,project,28,57,85,1.0
whisper-small,profit,9,76,85,1.0
GPT-4o mini Transcribe,they,25,60,85,1.0
whisper-small,slightly,22,63,85,1.0
GPT-4o mini Transcribe,q3,18,67,85,1.0
whisper-large-v3-turbo,part,37,48,85,1.0
whisper-large-v3-turbo,through,10,74,84,1.0
GPT-4o mini Transcribe,overall,19,65,84,1.0
GPT-4o mini Transcribe,group,27,57,84,1.0
whisper-large-v3-turbo,equivalent,6,78,84,1.0
whisper-large-v3-turbo,below,6,78,84,1.0
GPT-4o mini Transcribe,average,11,73,84,1.0
whisper-small,roughly,20,64,84,1.0
whisper-large-v3-turbo,again,22,61,83,1.0
whisper-large-v3-turbo,already,34,49,83,1.0
whisper-large-v3-turbo,sorry,21,62,83,1.0
GPT-4o mini Transcribe,okay,23,60,83,1.0
whisper-large-v3-turbo,plus,12,71,83,1.0
whisper-small,bit,28,55,83,1.0
GPT-4o mini Transcribe,result,25,58,83,1.0
whisper-small,reached,12,70,82,1.0
GPT-4o mini Transcribe,call,39,43,82,1.0
whisper-large-v3-turbo,reached,16,66,82,1.0
whisper-large-v3-turbo,even,23,59,82,1.0
whisper-large-v3-turbo,another,22,60,82,1.0
whisper-large-v3-turbo,decreased,10,72,82,1.0
GPT-4o mini Transcribe,any,25,56,81,1.0
whisper-large-v3-turbo,q4,18,63,81,1.0
whisper-small,since,31,50,81,1.0
whisper-large-v3-turbo,here,26,55,81,1.0
GPT-4o mini Transcribe,under,14,66,80,1.0
whisper-large-v3-turbo,related,18,62,80,1.0
whisper-small,distribution,17,63,80,1.0
whisper-small,seen,25,55,80,1.0
whisper-large-v3-turbo,times,17,63,80,1.0
whisper-large-v3-turbo,said,27,53,80,1.0
whisper-small,company,15,65,80,1.0
whisper-small,youre,35,44,79,1.0
whisper-small,excluding,18,61,79,1.0
whisper-small,covid,22,57,79,1.0
whisper-small,capacity,25,54,79,1.0
GPT-4o mini Transcribe,profit,19,60,79,1.0
whisper-large-v3-turbo,any,20,59,79,1.0
whisper-small,while,23,56,79,1.0
whisper-small,numbers,36,43,79,1.0
GPT-4o mini Transcribe,financial,13,65,78,1.0
whisper-small,gas,19,59,78,1.0
whisper-large-v3-turbo,tons,24,54,78,1.0
whisper-small,working,21,57,78,1.0
whisper-large-v3-turbo,barrels,3,75,78,1.0
whisper-large-v3-turbo,financial,20,58,78,1.0
whisper-large-v3-turbo,customers,17,61,78,1.0
whisper-large-v3-turbo,almost,20,57,77,1.0
GPT-4o mini Transcribe,maybe,17,60,77,1.0
GPT-4o mini Transcribe,go,28,49,77,1.0
whisper-large-v3-turbo,capex,22,55,77,1.0
whisper-small,shareholders,6,71,77,1.0
GPT-4o mini Transcribe,still,22,55,77,1.0
whisper-small,another,18,59,77,1.0
whisper-small,negative,13,64,77,1.0
GPT-4o mini Transcribe,through,21,56,77,1.0
whisper-small,part,18,59,77,1.0
whisper-small,base,18,59,77,1.0
GPT-4o mini Transcribe,should,28,49,77,1.0
whisper-small,ss,40,37,77,1.0
whisper-large-v3-turbo,full,24,52,76,1.0
whisper-large-v3-turbo,important,16,60,76,1.0
whisper-large-v3-turbo,profit,10,66,76,1.0
whisper-large-v3-turbo,costs,23,53,76,1.0
whisper-large-v3-turbo,before,15,61,76,1.0
whisper-small,across,29,47,76,1.0
GPT-4o mini Transcribe,gross,16,59,75,1.0
whisper-small,decrease,21,54,75,1.0
whisper-small,levels,14,61,75,1.0
whisper-small,full,12,63,75,1.0
whisper-large-v3-turbo,forward,24,51,75,1.0
whisper-small,group,9,66,75,1.0
whisper-small,course,24,51,75,1.0
whisper-small,only,33,42,75,1.0
whisper-large-v3-turbo,after,18,57,75,1.0
whisper-small,kind,24,51,75,1.0
GPT-4o mini Transcribe,expected,18,57,75,1.0
GPT-4o mini Transcribe,obviously,12,63,75,1.0
whisper-small,both,27,48,75,1.0
whisper-small,tty,29,46,75,1.0
GPT-4o mini Transcribe,lets,18,57,75,1.0
GPT-4o mini Transcribe,high,25,49,74,1.0
GPT-4o mini Transcribe,shareholders,3,71,74,1.0
whisper-small,theres,32,42,74,1.0
whisper-small,oil,6,68,74,1.0
whisper-small,data,22,52,74,1.0
whisper-large-v3-turbo,little,7,67,74,1.0
GPT-4o mini Transcribe,little,6,68,74,1.0
GPT-4o mini Transcribe,decrease,12,62,74,1.0
whisper-large-v3-turbo,gross,18,56,74,1.0
whisper-large-v3-turbo,sure,40,34,74,1.0
whisper-small,mean,41,33,74,1.0
whisper-small,debt,8,66,74,1.0
whisper-small,book,27,46,73,1.0
whisper-small,start,16,57,73,1.0
whisper-large-v3-turbo,result,19,54,73,1.0
whisper-small,other,10,62,72,1.0
whisper-large-v3-turbo,above,4,68,72,1.0
whisper-large-v3-turbo,less,21,51,72,1.0
whisper-large-v3-turbo,crores,9,63,72,1.0
whisper-large-v3-turbo,group,21,51,72,1.0
whisper-small,went,9,63,72,1.0
whisper-small,q4,24,48,72,1.0
GPT-4o mini Transcribe,decreased,7,65,72,1.0
whisper-small,ounces,0,72,72,1.0
GPT-4o mini Transcribe,between,16,56,72,1.0
whisper-small,big,33,39,72,1.0
whisper-small,generated,6,66,72,1.0
whisper-small,grow,6,66,72,1.0
whisper-large-v3-turbo,target,9,63,72,1.0
whisper-small,forward,21,51,72,1.0
GPT-4o mini Transcribe,ounces,0,72,72,1.0
whisper-small,projects,24,48,72,1.0
GPT-4o mini Transcribe,capex,23,48,71,1.0
whisper-large-v3-turbo,pandemic,28,43,71,1.0
whisper-small,q2,14,57,71,1.0
whisper-large-v3-turbo,energy,18,53,71,1.0
GPT-4o mini Transcribe,could,23,48,71,1.0
GPT-4o mini Transcribe,after,11,59,70,1.0
whisper-small,pandemic,30,40,70,1.0
whisper-large-v3-turbo,september,12,58,70,1.0
GPT-4o mini Transcribe,no,35,35,70,1.0
GPT-4o mini Transcribe,even,11,59,70,1.0
GPT-4o mini Transcribe,significant,21,49,70,1.0
whisper-small,being,19,51,70,1.0
whisper-small,low,26,43,69,1.0
whisper-large-v3-turbo,company,9,60,69,1.0
GPT-4o mini Transcribe,september,12,57,69,1.0
GPT-4o mini Transcribe,equivalent,9,60,69,1.0
GPT-4o mini Transcribe,back,32,37,69,1.0
whisper-small,volume,25,44,69,1.0
whisper-small,development,12,57,69,1.0
whisper-small,looking,17,52,69,1.0
whisper-large-v3-turbo,distribution,12,57,69,1.0
GPT-4o mini Transcribe,where,11,58,69,1.0
GPT-4o mini Transcribe,development,15,54,69,1.0
whisper-small,recorded,7,61,68,1.0
whisper-small,page,19,49,68,1.0
whisper-large-v3-turbo,mean,35,33,68,1.0
whisper-large-v3-turbo,tty,19,49,68,1.0
whisper-large-v3-turbo,other,28,40,68,1.0
GPT-4o mini Transcribe,how,17,51,68,1.0
whisper-large-v3-turbo,mentioned,24,44,68,1.0
whisper-small,acquisition,14,54,68,1.0
whisper-small,barrels,6,62,68,1.0
whisper-large-v3-turbo,since,28,40,68,1.0
whisper-large-v3-turbo,shareholders,3,65,68,1.0
GPT-4o mini Transcribe,target,15,53,68,1.0
whisper-small,almost,17,51,68,1.0
whisper-large-v3-turbo,levels,12,55,67,1.0
whisper-small,why,9,58,67,1.0
GPT-4o mini Transcribe,distribution,12,55,67,1.0
whisper-large-v3-turbo,mainly,6,61,67,1.0
whisper-small,yes,35,32,67,1.0
whisper-large-v3-turbo,term,16,51,67,1.0
whisper-large-v3-turbo,looking,17,50,67,1.0
whisper-small,free,8,59,67,1.0
whisper-small,mainly,9,58,67,1.0
GPT-4o mini Transcribe,less,19,48,67,1.0
whisper-large-v3-turbo,did,12,55,67,1.0
whisper-large-v3-turbo,diluted,0,66,66,1.0
whisper-large-v3-turbo,inr,3,63,66,1.0
whisper-small,really,23,43,66,1.0
whisper-small,digital,6,60,66,1.0
whisper-small,reais,6,60,66,1.0
GPT-4o mini Transcribe,continue,25,41,66,1.0
whisper-large-v3-turbo,across,29,37,66,1.0
GPT-4o mini Transcribe,me,34,32,66,1.0
whisper-small,energy,10,56,66,1.0
whisper-small,probably,20,46,66,1.0
whisper-small,equity,12,54,66,1.0
whisper-large-v3-turbo,volume,19,47,66,1.0
GPT-4o mini Transcribe,actually,18,48,66,1.0
GPT-4o mini Transcribe,times,12,54,66,1.0
whisper-small,sure,25,40,65,1.0
whisper-small,additional,30,35,65,1.0
whisper-small,within,24,41,65,1.0
GPT-4o mini Transcribe,term,8,57,65,1.0
whisper-large-v3-turbo,im,30,35,65,1.0
GPT-4o mini Transcribe,grew,18,47,65,1.0
GPT-4o mini Transcribe,while,15,49,64,1.0
whisper-small,month,13,51,64,1.0
whisper-small,driven,15,49,64,1.0
GPT-4o mini Transcribe,working,15,49,64,1.0
whisper-small,able,16,48,64,1.0
whisper-small,costs,19,45,64,1.0
whisper-large-v3-turbo,course,18,46,64,1.0
whisper-large-v3-turbo,theres,25,39,64,1.0
whisper-large-v3-turbo,grew,12,52,64,1.0
whisper-large-v3-turbo,given,16,48,64,1.0
whisper-large-v3-turbo,projects,33,30,63,1.0
whisper-large-v3-turbo,dont,28,35,63,1.0
GPT-4o mini Transcribe,only,25,38,63,1.0
GPT-4o mini Transcribe,seen,11,52,63,1.0
whisper-large-v3-turbo,moving,19,44,63,1.0
whisper-small,taking,50,13,63,1.0
GPT-4o mini Transcribe,went,6,57,63,1.0
whisper-small,balance,20,43,63,1.0
whisper-small,got,27,36,63,1.0
whisper-large-v3-turbo,youre,28,35,63,1.0
whisper-small,few,28,35,63,1.0
whisper-large-v3-turbo,ss,45,18,63,1.0
whisper-small,long,26,37,63,1.0
whisper-large-v3-turbo,equity,13,50,63,1.0
whisper-large-v3-turbo,may,36,27,63,1.0
whisper-large-v3-turbo,quite,22,40,62,1.0
whisper-large-v3-turbo,both,13,49,62,1.0
whisper-large-v3-turbo,position,7,55,62,1.0
whisper-small,diluted,0,62,62,1.0
whisper-large-v3-turbo,lot,23,39,62,1.0
GPT-4o mini Transcribe,here,13,49,62,1.0
whisper-small,dont,16,46,62,1.0
GPT-4o mini Transcribe,diluted,0,62,62,1.0
GPT-4o mini Transcribe,related,10,52,62,1.0
GPT-4o mini Transcribe,driven,26,36,62,1.0
whisper-small,ago,30,32,62,1.0
whisper-small,early,18,44,62,1.0
GPT-4o mini Transcribe,levels,9,52,61,1.0
GPT-4o mini Transcribe,q4,21,40,61,1.0
whisper-large-v3-turbo,page,21,40,61,1.0
whisper-large-v3-turbo,better,23,38,61,1.0
whisper-large-v3-turbo,start,6,55,61,1.0
GPT-4o mini Transcribe,early,12,49,61,1.0
whisper-large-v3-turbo,value,9,52,61,1.0
whisper-small,given,15,46,61,1.0
whisper-small,key,33,28,61,1.0
whisper-large-v3-turbo,got,31,30,61,1.0
whisper-small,better,19,42,61,1.0
whisper-small,need,24,37,61,1.0
whisper-large-v3-turbo,thanks,23,38,61,1.0
whisper-small,margins,17,44,61,1.0
whisper-large-v3-turbo,product,23,37,60,1.0
whisper-large-v3-turbo,working,19,41,60,1.0
GPT-4o mini Transcribe,barrels,6,54,60,1.0
GPT-4o mini Transcribe,america,13,47,60,1.0
whisper-large-v3-turbo,ounces,3,57,60,1.0
GPT-4o mini Transcribe,looking,10,50,60,1.0
whisper-small,barrel,3,57,60,1.0
whisper-small,may,42,18,60,1.0
whisper-large-v3-turbo,month,18,42,60,1.0
GPT-4o mini Transcribe,above,4,56,60,1.0
GPT-4o mini Transcribe,bit,4,56,60,1.0
whisper-small,move,32,28,60,1.0
whisper-large-v3-turbo,prior,9,50,59,1.0
whisper-large-v3-turbo,additional,30,29,59,1.0
whisper-small,annual,9,50,59,1.0
whisper-small,zero,3,56,59,1.0
whisper-large-v3-turbo,bit,8,51,59,1.0
whisper-small,prices,21,38,59,1.0
whisper-large-v3-turbo,balance,16,43,59,1.0
whisper-small,important,2,57,59,1.0
GPT-4o mini Transcribe,impact,19,40,59,1.0
whisper-large-v3-turbo,markets,16,43,59,1.0
GPT-4o mini Transcribe,course,3,55,58,1.0
GPT-4o mini Transcribe,youre,17,41,58,1.0
GPT-4o mini Transcribe,volume,22,36,58,1.0
whisper-large-v3-turbo,acquisition,5,53,58,1.0
whisper-large-v3-turbo,seen,7,51,58,1.0
GPT-4o mini Transcribe,base,15,43,58,1.0
GPT-4o mini Transcribe,before,6,52,58,1.0
whisper-small,markets,14,43,57,1.0
whisper-large-v3-turbo,only,19,38,57,1.0
whisper-large-v3-turbo,take,27,30,57,1.0
whisper-small,based,7,50,57,1.0
whisper-small,reaching,6,51,57,1.0
whisper-large-v3-turbo,driven,13,44,57,1.0
whisper-large-v3-turbo,generated,7,50,57,1.0
GPT-4o mini Transcribe,line,20,37,57,1.0
GPT-4o mini Transcribe,projects,30,27,57,1.0
GPT-4o mini Transcribe,acquisition,3,54,57,1.0
whisper-large-v3-turbo,reach,9,48,57,1.0
whisper-small,coming,24,33,57,1.0
GPT-4o mini Transcribe,already,18,39,57,1.0
GPT-4o mini Transcribe,almost,4,52,56,1.0
whisper-small,investment,12,44,56,1.0
GPT-4o mini Transcribe,said,15,41,56,1.0
GPT-4o mini Transcribe,costs,18,38,56,1.0
whisper-large-v3-turbo,development,18,38,56,1.0
whisper-small,people,18,38,56,1.0
whisper-large-v3-turbo,project,13,43,56,1.0
whisper-large-v3-turbo,data,21,35,56,1.0
whisper-small,use,18,38,56,1.0
GPT-4o mini Transcribe,energy,19,37,56,1.0
whisper-small,organic,15,41,56,1.0
whisper-large-v3-turbo,able,6,50,56,1.0
GPT-4o mini Transcribe,roughly,15,41,56,1.0
whisper-small,expansion,7,49,56,1.0
whisper-large-v3-turbo,give,22,34,56,1.0
GPT-4o mini Transcribe,value,6,49,55,1.0
GPT-4o mini Transcribe,data,18,37,55,1.0
whisper-large-v3-turbo,covid,19,36,55,1.0
whisper-large-v3-turbo,me,19,36,55,1.0
whisper-large-v3-turbo,debt,7,48,55,1.0
whisper-large-v3-turbo,talk,27,28,55,1.0
whisper-large-v3-turbo,went,1,54,55,1.0
whisper-small,rates,21,34,55,1.0
whisper-small,get,21,34,55,1.0
GPT-4o mini Transcribe,questions,27,28,55,1.0
whisper-small,orders,7,48,55,1.0
whisper-small,remaining,7,48,55,1.0
whisper-small,quarters,27,28,55,1.0
GPT-4o mini Transcribe,given,5,50,55,1.0
GPT-4o mini Transcribe,did,13,41,54,1.0
whisper-small,5g,27,27,54,1.0
whisper-large-v3-turbo,why,12,42,54,1.0
whisper-small,sort,21,33,54,1.0
whisper-small,program,17,37,54,1.0
whisper-small,contribution,6,48,54,1.0
whisper-large-v3-turbo,negative,3,51,54,1.0
whisper-small,asset,8,46,54,1.0
whisper-large-v3-turbo,numbers,18,36,54,1.0
whisper-small,give,5,49,54,1.0
GPT-4o mini Transcribe,capacity,7,47,54,1.0
GPT-4o mini Transcribe,since,19,35,54,1.0
whisper-large-v3-turbo,low,26,28,54,1.0
whisper-small,product,28,26,54,1.0
whisper-large-v3-turbo,june,8,46,54,1.0
whisper-small,quite,19,35,54,1.0
whisper-small,way,23,31,54,1.0
GPT-4o mini Transcribe,sort,19,34,53,1.0
whisper-large-v3-turbo,grow,6,47,53,1.0
whisper-large-v3-turbo,being,13,40,53,1.0
GPT-4o mini Transcribe,position,6,47,53,1.0
whisper-small,plan,12,41,53,1.0
whisper-small,representing,7,46,53,1.0
GPT-4o mini Transcribe,project,6,47,53,1.0
GPT-4o mini Transcribe,debt,7,46,53,1.0
whisper-large-v3-turbo,within,14,39,53,1.0
whisper-small,operations,16,37,53,1.0
GPT-4o mini Transcribe,take,14,39,53,1.0
GPT-4o mini Transcribe,grow,6,47,53,1.0
whisper-large-v3-turbo,oil,0,53,53,1.0
GPT-4o mini Transcribe,mentioned,21,32,53,1.0
GPT-4o mini Transcribe,recorded,6,46,52,1.0
GPT-4o mini Transcribe,another,4,48,52,1.0
whisper-large-v3-turbo,key,18,34,52,1.0
GPT-4o mini Transcribe,thousand,9,43,52,1.0
GPT-4o mini Transcribe,mainly,9,43,52,1.0
GPT-4o mini Transcribe,yes,16,36,52,1.0
GPT-4o mini Transcribe,numbers,27,25,52,1.0
GPT-4o mini Transcribe,contribution,0,52,52,1.0
whisper-small,despite,24,28,52,1.0
whisper-large-v3-turbo,early,6,46,52,1.0
whisper-large-v3-turbo,eps,6,46,52,1.0
whisper-large-v3-turbo,move,24,28,52,1.0
whisper-small,side,20,31,51,1.0
whisper-small,march,10,41,51,1.0
GPT-4o mini Transcribe,june,9,42,51,1.0
GPT-4o mini Transcribe,thanks,13,38,51,1.0
whisper-large-v3-turbo,respectively,3,48,51,1.0
whisper-large-v3-turbo,coming,24,27,51,1.0
whisper-large-v3-turbo,roughly,13,38,51,1.0
whisper-large-v3-turbo,excluding,12,39,51,1.0
whisper-large-v3-turbo,slightly,18,33,51,1.0
whisper-small,rd,3,48,51,1.0
GPT-4o mini Transcribe,margins,16,35,51,1.0
whisper-large-v3-turbo,while,10,41,51,1.0
whisper-large-v3-turbo,recorded,7,44,51,1.0
whisper-large-v3-turbo,prices,21,30,51,1.0
whisper-small,continued,18,33,51,1.0
whisper-small,order,9,42,51,1.0
whisper-small,inr,12,39,51,1.0
GPT-4o mini Transcribe,being,16,35,51,1.0
whisper-small,interest,7,43,50,1.0
GPT-4o mini Transcribe,big,17,33,50,1.0
whisper-small,did,9,41,50,1.0
whisper-large-v3-turbo,work,22,28,50,1.0
whisper-large-v3-turbo,plan,7,43,50,1.0
whisper-small,least,15,35,50,1.0
GPT-4o mini Transcribe,other,14,36,50,1.0
whisper-small,comes,34,16,50,1.0
whisper-large-v3-turbo,march,4,46,50,1.0
whisper-large-v3-turbo,based,9,41,50,1.0
whisper-large-v3-turbo,really,20,30,50,1.0
whisper-large-v3-turbo,representing,3,47,50,1.0
GPT-4o mini Transcribe,important,12,38,50,1.0
GPT-4o mini Transcribe,liquidity,9,41,50,1.0
whisper-large-v3-turbo,base,16,34,50,1.0
GPT-4o mini Transcribe,date,6,44,50,1.0
