variant,token,correct,missing,substituted,total,error_rate
whisper-small,ounces,42,42,27,111,0.6216216216216216
GPT-4o mini Transcribe,ounces,45,45,21,111,0.5945945945945945
whisper-large-v3-turbo,ounces,57,30,24,111,0.4864864864864865
whisper-large-v3-turbo,cents,367,105,167,639,0.4256651017214398
GPT-4o mini Transcribe,cents,396,78,163,637,0.37833594976452123
whisper-small,comparison,58,15,18,91,0.3626373626373627
whisper-small,variance,33,15,3,51,0.3529411764705882
whisper-small,yield,53,27,0,80,0.3375
whisper-small,gold,37,18,0,55,0.32727272727272727
GPT-4o mini Transcribe,gold,37,18,0,55,0.32727272727272727
whisper-small,rs,69,15,18,102,0.32352941176470584
whisper-small,implying,39,15,3,57,0.3157894736842105
whisper-small,commodity,36,10,6,52,0.3076923076923077
whisper-small,cents,447,79,113,639,0.3004694835680751
GPT-4o mini Transcribe,meeting,57,12,12,81,0.2962962962962963
whisper-large-v3-turbo,historical,37,9,6,52,0.28846153846153844
GPT-4o mini Transcribe,amortization,38,6,9,53,0.28301886792452835
whisper-large-v3-turbo,millions,76,27,3,106,0.28301886792452835
whisper-large-v3-turbo,bottom,51,10,10,71,0.2816901408450704
whisper-small,sustaining,69,12,15,96,0.28125
whisper-small,shareholders,130,42,8,180,0.2777777777777778
whisper-small,trillion,322,90,33,445,0.2764044943820225
GPT-4o mini Transcribe,trillion,322,114,9,445,0.2764044943820225
whisper-large-v3-turbo,shareholder,48,15,3,66,0.2727272727272727
whisper-small,reals,48,18,0,66,0.2727272727272727
whisper-large-v3-turbo,reals,48,9,9,66,0.2727272727272727
GPT-4o mini Transcribe,reals,48,15,3,66,0.2727272727272727
whisper-large-v3-turbo,trillion,325,105,15,445,0.2696629213483146
whisper-small,consideration,38,11,3,52,0.2692307692307693
whisper-large-v3-turbo,guide,49,12,6,67,0.26865671641791045
whisper-small,attributable,129,26,21,176,0.2670454545454546
whisper-small,sure,44,13,3,60,0.2666666666666667
whisper-small,deposits,50,15,3,68,0.2647058823529411
whisper-large-v3-turbo,thing,50,12,6,68,0.2647058823529411
GPT-4o mini Transcribe,shareholders,139,39,11,189,0.26455026455026454
whisper-large-v3-turbo,comparison,67,18,6,91,0.2637362637362637
whisper-small,copper,42,6,9,57,0.26315789473684215
whisper-large-v3-turbo,shareholders,133,45,2,180,0.26111111111111107
whisper-small,zloty,60,15,6,81,0.2592592592592593
GPT-4o mini Transcribe,diluted,137,13,34,184,0.2554347826086957
whisper-small,millions,79,18,9,106,0.2547169811320755
whisper-small,sell,44,12,3,59,0.2542372881355932
GPT-4o mini Transcribe,ounce,62,15,6,83,0.2530120481927711
whisper-small,ounce,62,12,9,83,0.2530120481927711
whisper-small,position,234,56,23,313,0.25239616613418525
whisper-small,historical,39,4,9,52,0.25
GPT-4o mini Transcribe,sustaining,72,15,9,96,0.25
GPT-4o mini Transcribe,sure,50,16,0,66,0.24242424242424243
whisper-large-v3-turbo,diluted,142,10,35,187,0.2406417112299465
GPT-4o mini Transcribe,went,172,36,18,226,0.23893805309734517
whisper-large-v3-turbo,fy,48,12,3,63,0.23809523809523814
GPT-4o mini Transcribe,fy,48,12,3,63,0.23809523809523814
GPT-4o mini Transcribe,rubles,48,15,0,63,0.23809523809523814
whisper-small,policy,96,30,0,126,0.23809523809523814
whisper-small,rubles,48,15,0,63,0.23809523809523814
whisper-small,fy,48,15,0,63,0.23809523809523814
whisper-large-v3-turbo,variance,39,9,3,51,0.23529411764705888
GPT-4o mini Transcribe,rs,78,6,18,102,0.23529411764705888
whisper-large-v3-turbo,went,166,42,9,217,0.23502304147465436
whisper-small,rupees,69,6,15,90,0.23333333333333328
whisper-large-v3-turbo,buyback,43,9,4,56,0.2321428571428571
whisper-small,reaching,120,27,9,156,0.23076923076923073
whisper-large-v3-turbo,china,50,12,3,65,0.23076923076923073
whisper-small,equivalent,192,45,12,249,0.22891566265060237
whisper-small,shareholder,51,12,3,66,0.2272727272727273
GPT-4o mini Transcribe,attributable,136,19,21,176,0.2272727272727273
GPT-4o mini Transcribe,millions,82,18,6,106,0.2264150943396226
whisper-large-v3-turbo,moment,41,9,3,53,0.2264150943396226
GPT-4o mini Transcribe,proposed,62,15,3,80,0.22499999999999998
whisper-small,proposed,62,9,9,80,0.22499999999999998
whisper-small,facility,45,10,3,58,0.22413793103448276
whisper-large-v3-turbo,meeting,63,12,6,81,0.2222222222222222
whisper-small,oil,102,11,18,131,0.22137404580152675
whisper-small,went,169,42,6,217,0.2211981566820277
whisper-large-v3-turbo,deposits,53,15,0,68,0.22058823529411764
whisper-small,stood,146,25,16,187,0.2192513368983957
whisper-large-v3-turbo,sustaining,75,6,15,96,0.21875
whisper-large-v3-turbo,gold,43,12,0,55,0.21818181818181814
whisper-small,board,102,16,12,130,0.2153846153846154
whisper-large-v3-turbo,compensation,95,15,11,121,0.2148760330578512
whisper-small,buyback,44,9,3,56,0.2142857142857143
GPT-4o mini Transcribe,buyback,44,6,6,56,0.2142857142857143
whisper-small,provisions,66,9,9,84,0.2142857142857143
whisper-small,forecast,362,60,38,460,0.21304347826086956
whisper-large-v3-turbo,savings,63,2,15,80,0.21250000000000002
whisper-large-v3-turbo,consideration,41,10,1,52,0.21153846153846156
whisper-large-v3-turbo,remind,45,9,3,57,0.21052631578947367
whisper-large-v3-turbo,implying,45,12,0,57,0.21052631578947367
whisper-small,stronger,60,12,4,76,0.21052631578947367
whisper-small,january,60,6,10,76,0.21052631578947367
GPT-4o mini Transcribe,copper,45,6,6,57,0.21052631578947367
whisper-small,pleased,49,6,7,62,0.20967741935483875
GPT-4o mini Transcribe,summary,49,3,10,62,0.20967741935483875
whisper-small,unchanged,68,15,3,86,0.2093023255813954
whisper-large-v3-turbo,accounts,87,20,3,110,0.2090909090909091
whisper-small,bank,72,12,7,91,0.20879120879120883
whisper-small,showing,57,3,12,72,0.20833333333333337
whisper-small,having,80,15,6,101,0.20792079207920788
whisper-small,id,61,9,7,77,0.20779220779220775
whisper-small,3rd,69,18,0,87,0.2068965517241379
whisper-large-v3-turbo,subscriber,46,6,6,58,0.2068965517241379
whisper-small,impairment,46,12,0,58,0.2068965517241379
whisper-large-v3-turbo,sure,50,13,0,63,0.2063492063492064
GPT-4o mini Transcribe,liquidity,127,21,12,160,0.20625000000000004
whisper-small,sorry,121,25,6,152,0.20394736842105265
GPT-4o mini Transcribe,sell,47,9,3,59,0.2033898305084746
whisper-large-v3-turbo,sell,47,12,0,59,0.2033898305084746
GPT-4o mini Transcribe,put,67,13,4,84,0.20238095238095233
whisper-small,dividend,738,128,59,925,0.2021621621621622
whisper-large-v3-turbo,march,79,16,4,99,0.202020202020202
GPT-4o mini Transcribe,sorry,119,21,9,149,0.20134228187919467
whisper-large-v3-turbo,proposed,64,16,0,80,0.19999999999999996
whisper-large-v3-turbo,forecast,368,48,44,460,0.19999999999999996
whisper-large-v3-turbo,particular,48,6,6,60,0.19999999999999996
GPT-4o mini Transcribe,portion,48,6,6,60,0.19999999999999996
whisper-small,beginning,72,15,3,90,0.19999999999999996
whisper-small,conditions,44,2,9,55,0.19999999999999996
whisper-small,particular,48,12,0,60,0.19999999999999996
GPT-4o mini Transcribe,comparison,73,15,3,91,0.19780219780219777
GPT-4o mini Transcribe,bank,73,9,9,91,0.19780219780219777
GPT-4o mini Transcribe,share,1036,111,144,1291,0.19752130131680867
whisper-small,x,61,13,2,76,0.19736842105263153
whisper-small,bottom,57,1,13,71,0.19718309859154926
GPT-4o mini Transcribe,guide,49,9,3,61,0.19672131147540983
GPT-4o mini Transcribe,uk,49,12,0,61,0.19672131147540983
whisper-large-v3-turbo,equivalent,198,42,6,246,0.19512195121951215
whisper-small,liquidity,129,31,0,160,0.19374999999999998
whisper-small,project,71,11,6,88,0.19318181818181823
whisper-small,diluted,151,14,22,187,0.1925133689839572
GPT-4o mini Transcribe,consideration,42,9,1,52,0.1923076923076923
whisper-small,delivery,63,9,6,78,0.1923076923076923
whisper-large-v3-turbo,share,1047,117,132,1296,0.19212962962962965
whisper-small,impacted,118,18,10,146,0.1917808219178082
GPT-4o mini Transcribe,oil,106,16,9,131,0.19083969465648853
whisper-large-v3-turbo,details,51,6,6,63,0.19047619047619047
whisper-small,data,119,12,16,147,0.19047619047619047
GPT-4o mini Transcribe,forecast,374,57,31,462,0.19047619047619047
GPT-4o mini Transcribe,updated,51,9,3,63,0.19047619047619047
whisper-small,details,51,12,0,63,0.19047619047619047
whisper-large-v3-turbo,rubles,51,12,0,63,0.19047619047619047
whisper-small,too,64,9,6,79,0.189873417721519
whisper-large-v3-turbo,ton,77,9,9,95,0.18947368421052635
whisper-small,share,1056,156,90,1302,0.18894009216589858
whisper-small,private,78,12,6,96,0.1875
whisper-large-v3-turbo,attributable,143,22,11,176,0.1875
whisper-small,largest,52,6,6,64,0.1875
GPT-4o mini Transcribe,accounts,87,15,5,107,0.1869158878504673
whisper-small,dollar,248,36,21,305,0.18688524590163935
whisper-small,meeting,66,9,6,81,0.18518518518518523
GPT-4o mini Transcribe,zloty,66,12,3,81,0.18518518518518523
whisper-small,theres,97,10,12,119,0.18487394957983194
whisper-small,yes,115,14,12,141,0.18439716312056742
whisper-small,exceeding,58,6,7,71,0.18309859154929575
whisper-small,per,1589,215,141,1945,0.1830334190231363
GPT-4o mini Transcribe,recurring,134,13,17,164,0.18292682926829273
whisper-small,funds,67,12,3,82,0.18292682926829273
whisper-small,positive,411,77,15,503,0.18290258449304175
whisper-large-v3-turbo,eps,152,13,21,186,0.18279569892473113
whisper-large-v3-turbo,way,94,6,15,115,0.18260869565217386
whisper-large-v3-turbo,won,54,12,0,66,0.18181818181818177
whisper-small,advances,54,6,6,66,0.18181818181818177
whisper-small,bridge,45,7,3,55,0.18181818181818177
GPT-4o mini Transcribe,shareholder,54,12,0,66,0.18181818181818177
whisper-small,sold,99,15,7,121,0.18181818181818177
GPT-4o mini Transcribe,strategic,68,6,9,83,0.1807228915662651
whisper-small,reais,177,21,18,216,0.18055555555555558
whisper-large-v3-turbo,3rd,69,15,0,84,0.1785714285714286
whisper-small,represents,152,24,9,185,0.17837837837837833
GPT-4o mini Transcribe,deposits,56,9,3,68,0.17647058823529416
GPT-4o mini Transcribe,averaged,42,0,9,51,0.17647058823529416
whisper-small,china,56,12,0,68,0.17647058823529416
whisper-small,cumulative,42,3,6,51,0.17647058823529416
whisper-large-v3-turbo,averaged,42,3,6,51,0.17647058823529416
whisper-small,resulting,112,20,4,136,0.17647058823529416
whisper-small,averaged,42,0,9,51,0.17647058823529416
whisper-small,penetration,42,9,0,51,0.17647058823529416
whisper-small,thing,56,6,6,68,0.17647058823529416
whisper-small,contract,56,6,6,68,0.17647058823529416
GPT-4o mini Transcribe,penetration,42,9,0,51,0.17647058823529416
whisper-large-v3-turbo,got,100,18,3,121,0.17355371900826444
GPT-4o mini Transcribe,front,43,9,0,52,0.17307692307692313
GPT-4o mini Transcribe,historical,43,3,6,52,0.17307692307692313
GPT-4o mini Transcribe,reaching,129,15,12,156,0.17307692307692313
GPT-4o mini Transcribe,3rd,72,15,0,87,0.1724137931034483
GPT-4o mini Transcribe,facility,48,10,0,58,0.1724137931034483
whisper-small,lira,72,15,0,87,0.1724137931034483
whisper-large-v3-turbo,facility,48,10,0,58,0.1724137931034483
whisper-large-v3-turbo,lira,72,15,0,87,0.1724137931034483
whisper-small,after,332,50,19,401,0.17206982543640903
whisper-small,joining,58,3,9,70,0.17142857142857137
whisper-large-v3-turbo,stronger,63,12,1,76,0.17105263157894735
GPT-4o mini Transcribe,equivalent,204,30,12,246,0.1707317073170732
GPT-4o mini Transcribe,per,1604,155,175,1934,0.17063081695966908
whisper-large-v3-turbo,they,161,26,7,194,0.1701030927835051
whisper-large-v3-turbo,actual,44,6,3,53,0.16981132075471694
whisper-small,important,132,6,21,159,0.16981132075471694
whisper-small,compound,44,6,3,53,0.16981132075471694
whisper-small,moment,44,6,3,53,0.16981132075471694
GPT-4o mini Transcribe,moment,44,6,3,53,0.16981132075471694
whisper-small,prices,181,22,15,218,0.16972477064220182
whisper-small,improvements,49,7,3,59,0.1694915254237288
whisper-large-v3-turbo,reach,147,26,4,177,0.1694915254237288
whisper-large-v3-turbo,improvements,49,6,4,59,0.1694915254237288
whisper-small,got,103,12,9,124,0.16935483870967738
whisper-large-v3-turbo,position,265,22,32,319,0.16927899686520376
whisper-large-v3-turbo,board,108,17,5,130,0.16923076923076918
whisper-large-v3-turbo,dollar,256,26,26,308,0.16883116883116878
whisper-small,tons,109,10,12,131,0.16793893129770987
whisper-small,consolidated,218,25,19,262,0.16793893129770987
whisper-small,aim,60,9,3,72,0.16666666666666663
whisper-large-v3-turbo,aim,60,12,0,72,0.16666666666666663
whisper-large-v3-turbo,committed,65,12,1,78,0.16666666666666663
whisper-small,remind,45,6,3,54,0.16666666666666663
whisper-small,showed,45,6,3,54,0.16666666666666663
whisper-small,trends,45,6,3,54,0.16666666666666663
GPT-4o mini Transcribe,compensation,101,6,14,121,0.1652892561983471
whisper-small,compensation,101,15,5,121,0.1652892561983471
whisper-large-v3-turbo,bank,76,9,6,91,0.1648351648351648
whisper-large-v3-turbo,talk,66,4,9,79,0.16455696202531644
whisper-large-v3-turbo,little,143,22,6,171,0.16374269005847952
whisper-small,strongly,46,9,0,55,0.1636363636363637
GPT-4o mini Transcribe,recovering,46,0,9,55,0.1636363636363637
whisper-large-v3-turbo,front,46,9,0,55,0.1636363636363637
whisper-large-v3-turbo,per,1623,147,170,1940,0.16340206185567008
GPT-4o mini Transcribe,ton,77,12,3,92,0.1630434782608695
whisper-small,savings,67,3,10,80,0.16249999999999998
whisper-small,ton,78,9,6,93,0.16129032258064513
GPT-4o mini Transcribe,pleased,52,3,7,62,0.16129032258064513
GPT-4o mini Transcribe,voice,78,6,9,93,0.16129032258064513
whisper-small,voice,78,9,6,93,0.16129032258064513
whisper-small,less,198,27,11,236,0.1610169491525424
whisper-small,little,146,21,7,174,0.16091954022988508
whisper-small,amortization,47,6,3,56,0.1607142857142857
whisper-large-v3-turbo,amortization,47,6,3,56,0.1607142857142857
whisper-small,pandemic,173,28,5,206,0.1601941747572816
whisper-large-v3-turbo,distribution,147,23,5,175,0.16000000000000003
whisper-large-v3-turbo,copper,48,9,0,57,0.1578947368421053
whisper-large-v3-turbo,resulting,112,18,3,133,0.1578947368421053
whisper-small,decided,48,0,9,57,0.1578947368421053
whisper-large-v3-turbo,following,102,9,10,121,0.15702479338842978
whisper-small,recorded,226,33,9,268,0.15671641791044777
whisper-small,way,97,12,6,115,0.15652173913043477
whisper-large-v3-turbo,power,81,12,3,96,0.15625
whisper-small,power,81,12,3,96,0.15625
whisper-small,generated,260,35,13,308,0.1558441558441559
whisper-large-v3-turbo,maintain,87,9,7,103,0.15533980582524276
whisper-small,guide,49,9,0,58,0.15517241379310343
GPT-4o mini Transcribe,progress,49,9,0,58,0.15517241379310343
GPT-4o mini Transcribe,subscriber,49,0,9,58,0.15517241379310343
whisper-small,never,49,9,0,58,0.15517241379310343
whisper-small,subscriber,49,6,3,58,0.15517241379310343
whisper-small,adjustment,49,3,6,58,0.15517241379310343
whisper-small,recovering,49,0,9,58,0.15517241379310343
whisper-large-v3-turbo,positive,425,63,15,503,0.15506958250497016
whisper-small,tl,180,21,12,213,0.15492957746478875
whisper-small,they,164,16,14,194,0.15463917525773196
whisper-large-v3-turbo,mix,159,21,8,188,0.1542553191489362
GPT-4o mini Transcribe,delivery,66,9,3,78,0.15384615384615385
whisper-large-v3-turbo,build,66,9,3,78,0.15384615384615385
whisper-small,gas,143,16,10,169,0.15384615384615385
whisper-small,continuing,66,6,6,78,0.15384615384615385
whisper-small,tty,110,19,1,130,0.15384615384615385
whisper-large-v3-turbo,reaching,132,21,3,156,0.15384615384615385
whisper-small,31st,83,6,9,98,0.15306122448979587
GPT-4o mini Transcribe,corresponding,72,3,10,85,0.15294117647058825
whisper-large-v3-turbo,liquidity,133,18,6,157,0.15286624203821653
GPT-4o mini Transcribe,evolution,100,6,12,118,0.15254237288135597
whisper-small,comment,50,9,0,59,0.15254237288135597
whisper-small,supported,100,9,9,118,0.15254237288135597
whisper-large-v3-turbo,progress,50,9,0,59,0.15254237288135597
whisper-large-v3-turbo,hand,139,24,1,164,0.15243902439024393
whisper-small,real,67,12,0,79,0.15189873417721522
whisper-small,addition,162,12,17,191,0.1518324607329843
whisper-small,single,123,3,19,145,0.15172413793103445
whisper-small,under,224,33,7,264,0.1515151515151515
GPT-4o mini Transcribe,change,101,9,9,119,0.1512605042016807
whisper-small,further,118,15,6,139,0.15107913669064743
GPT-4o mini Transcribe,dollar,259,19,27,305,0.15081967213114755
GPT-4o mini Transcribe,yes,107,7,12,126,0.1507936507936508
whisper-large-v3-turbo,any,237,34,8,279,0.15053763440860213
GPT-4o mini Transcribe,dividend,786,81,58,925,0.1502702702702703
whisper-small,components,51,6,3,60,0.15000000000000002
whisper-small,yeah,238,7,35,280,0.15000000000000002
whisper-large-v3-turbo,portion,51,6,3,60,0.15000000000000002
whisper-small,conversion,68,9,3,80,0.15000000000000002
GPT-4o mini Transcribe,yield,68,9,3,80,0.15000000000000002
whisper-large-v3-turbo,isas,51,9,0,60,0.15000000000000002
whisper-small,companys,108,12,7,127,0.14960629921259838
whisper-small,building,57,6,4,67,0.14925373134328357
whisper-large-v3-turbo,explained,103,12,6,121,0.14876033057851235
GPT-4o mini Transcribe,sold,103,12,6,121,0.14876033057851235
whisper-small,distribution,149,22,4,175,0.14857142857142858
whisper-large-v3-turbo,sorry,132,22,1,155,0.1483870967741936
GPT-4o mini Transcribe,earnings,752,65,66,883,0.14835787089467722
GPT-4o mini Transcribe,danish,69,9,3,81,0.14814814814814814
whisper-small,cagr,69,6,6,81,0.14814814814814814
whisper-large-v3-turbo,turkish,69,12,0,81,0.14814814814814814
whisper-small,turkish,69,12,0,81,0.14814814814814814
whisper-small,contributed,121,3,18,142,0.147887323943662
GPT-4o mini Transcribe,contributed,121,9,12,142,0.147887323943662
whisper-large-v3-turbo,synergies,52,6,3,61,0.14754098360655743
whisper-large-v3-turbo,uk,52,9,0,61,0.14754098360655743
whisper-small,uk,52,6,3,61,0.14754098360655743
whisper-large-v3-turbo,under,220,33,5,258,0.1472868217054264
whisper-small,remains,145,13,12,170,0.1470588235294118
whisper-small,perspective,58,4,6,68,0.1470588235294118
whisper-large-v3-turbo,rs,87,0,15,102,0.1470588235294118
whisper-small,very,896,108,46,1050,0.1466666666666666
GPT-4o mini Transcribe,funds,70,12,0,82,0.14634146341463417
whisper-small,industrial,105,12,6,123,0.14634146341463417
whisper-large-v3-turbo,funds,70,12,0,82,0.14634146341463417
whisper-large-v3-turbo,dividend,790,88,47,925,0.1459459459459459
whisper-small,few,82,7,7,96,0.14583333333333337
GPT-4o mini Transcribe,data,123,12,9,144,0.14583333333333337
GPT-4o mini Transcribe,confident,53,3,6,62,0.14516129032258063
whisper-small,confident,53,0,9,62,0.14516129032258063
whisper-large-v3-turbo,comment,53,9,0,62,0.14516129032258063
whisper-large-v3-turbo,confident,53,0,9,62,0.14516129032258063
whisper-large-v3-turbo,oil,112,13,6,131,0.14503816793893132
whisper-small,working,248,20,22,290,0.1448275862068965
whisper-small,part,142,7,17,166,0.14457831325301207
whisper-large-v3-turbo,ounce,71,0,12,83,0.14457831325301207
whisper-small,target,243,21,20,284,0.14436619718309862
whisper-small,crores,267,21,24,312,0.14423076923076927
whisper-large-v3-turbo,having,89,12,3,104,0.14423076923076927
GPT-4o mini Transcribe,having,89,12,3,104,0.14423076923076927
whisper-large-v3-turbo,tons,107,3,15,125,0.14400000000000002
whisper-small,why,125,12,9,146,0.14383561643835618
whisper-large-v3-turbo,updated,54,6,3,63,0.1428571428571429
GPT-4o mini Transcribe,policy,108,15,3,126,0.1428571428571429
whisper-small,equipment,60,4,6,70,0.1428571428571429
whisper-small,updated,54,3,6,63,0.1428571428571429
whisper-large-v3-turbo,data,126,18,3,147,0.1428571428571429
whisper-large-v3-turbo,provisions,72,9,3,84,0.1428571428571429
whisper-large-v3-turbo,many,60,3,7,70,0.1428571428571429
whisper-large-v3-turbo,h1,144,24,0,168,0.1428571428571429
GPT-4o mini Transcribe,position,271,19,26,316,0.14240506329113922
whisper-small,point,422,34,36,492,0.1422764227642277
whisper-large-v3-turbo,yen,1179,132,63,1374,0.14192139737991272
whisper-small,general,115,16,3,134,0.14179104477611937
whisper-small,obviously,297,39,10,346,0.14161849710982655
GPT-4o mini Transcribe,led,97,15,1,113,0.1415929203539823
whisper-large-v3-turbo,incremental,91,6,9,106,0.14150943396226412
whisper-small,use,91,12,3,106,0.14150943396226412
whisper-small,clearly,91,12,3,106,0.14150943396226412
GPT-4o mini Transcribe,eps,170,1,27,198,0.14141414141414144
whisper-small,march,85,14,0,99,0.14141414141414144
whisper-small,acquired,122,12,8,142,0.14084507042253525
whisper-large-v3-turbo,did,116,9,10,135,0.14074074074074072
GPT-4o mini Transcribe,included,171,16,12,199,0.14070351758793975
whisper-small,weve,400,34,31,465,0.13978494623655913
whisper-small,earnings,782,82,45,909,0.1397139713971397
GPT-4o mini Transcribe,improve,111,6,12,129,0.13953488372093026
whisper-large-v3-turbo,whole,74,9,3,86,0.13953488372093026
whisper-small,able,105,9,8,122,0.139344262295082
whisper-small,announced,136,13,9,158,0.1392405063291139
whisper-large-v3-turbo,announced,136,19,3,158,0.1392405063291139
whisper-small,recurring,136,13,9,158,0.1392405063291139
GPT-4o mini Transcribe,yen,1191,153,39,1383,0.1388286334056399
whisper-small,much,298,30,18,346,0.138728323699422
whisper-small,vious,472,45,31,548,0.13868613138686137
whisper-small,revenues,559,59,31,649,0.13867488443759635
GPT-4o mini Transcribe,coverage,56,9,0,65,0.1384615384615384
GPT-4o mini Transcribe,lira,75,12,0,87,0.13793103448275867
whisper-small,led,100,15,1,116,0.13793103448275867
whisper-large-v3-turbo,theres,100,9,7,116,0.13793103448275867
whisper-large-v3-turbo,part,144,10,13,167,0.13772455089820357
whisper-large-v3-turbo,their,138,16,6,160,0.13749999999999996
GPT-4o mini Transcribe,half,628,37,63,728,0.13736263736263732
whisper-small,range,490,51,27,568,0.13732394366197187
whisper-small,mentioned,289,31,15,335,0.13731343283582087
whisper-large-v3-turbo,reason,44,7,0,51,0.13725490196078427
whisper-large-v3-turbo,barrels,151,21,3,175,0.13714285714285712
whisper-large-v3-turbo,inflation,107,11,6,124,0.13709677419354838
whisper-small,sheet,170,24,3,197,0.13705583756345174
whisper-small,release,63,6,4,73,0.136986301369863
whisper-large-v3-turbo,totaled,126,20,0,146,0.136986301369863
GPT-4o mini Transcribe,totaled,126,19,1,146,0.136986301369863
whisper-small,talking,63,7,3,73,0.136986301369863
whisper-large-v3-turbo,half,624,34,65,723,0.13692946058091282
whisper-large-v3-turbo,earnings,769,66,56,891,0.1369248035914703
whisper-small,been,569,50,40,659,0.13657056145675261
whisper-small,sent,76,12,0,88,0.13636363636363635
GPT-4o mini Transcribe,won,57,9,0,66,0.13636363636363635
whisper-small,driver,76,9,3,88,0.13636363636363635
whisper-large-v3-turbo,acquisition,178,13,15,206,0.13592233009708743
GPT-4o mini Transcribe,resulting,115,14,4,133,0.13533834586466165
whisper-small,believe,128,12,8,148,0.1351351351351351
whisper-small,review,45,7,0,52,0.13461538461538458
whisper-large-v3-turbo,commodity,45,7,0,52,0.13461538461538458
whisper-small,actually,238,28,9,275,0.13454545454545452
whisper-large-v3-turbo,development,193,19,11,223,0.13452914798206284
GPT-4o mini Transcribe,development,193,22,8,223,0.13452914798206284
whisper-small,development,193,26,4,223,0.13452914798206284
GPT-4o mini Transcribe,closing,58,9,0,67,0.13432835820895528
whisper-large-v3-turbo,started,58,3,6,67,0.13432835820895528
whisper-small,closing,58,9,0,67,0.13432835820895528
whisper-large-v3-turbo,closing,58,9,0,67,0.13432835820895528
whisper-small,sort,129,18,2,149,0.13422818791946312
GPT-4o mini Transcribe,following,97,6,9,112,0.1339285714285714
whisper-small,long,220,24,10,254,0.13385826771653542
whisper-large-v3-turbo,close,292,18,27,337,0.13353115727002962
whisper-small,construction,78,0,12,90,0.1333333333333333
GPT-4o mini Transcribe,30th,65,9,1,75,0.1333333333333333
whisper-small,figure,104,10,6,120,0.1333333333333333
whisper-small,value,267,37,4,308,0.13311688311688308
whisper-small,price,1011,89,66,1166,0.13293310463121788
whisper-small,mid,98,6,9,113,0.1327433628318584
whisper-small,momentum,85,9,4,98,0.13265306122448983
whisper-small,q3,628,70,26,724,0.13259668508287292
whisper-large-v3-turbo,obviously,301,36,10,347,0.13256484149855907
whisper-small,strategic,72,11,0,83,0.1325301204819277
GPT-4o mini Transcribe,after,347,25,28,400,0.13249999999999995
whisper-small,billion,4337,466,196,4999,0.13242648529705936
whisper-small,an,1994,160,144,2298,0.13228894691035686
whisper-small,q1,361,37,18,416,0.13221153846153844
whisper-large-v3-turbo,beginning,79,6,6,91,0.13186813186813184
GPT-4o mini Transcribe,way,99,9,6,114,0.13157894736842102
GPT-4o mini Transcribe,distribution,152,21,2,175,0.13142857142857145
whisper-small,transactions,86,12,1,99,0.13131313131313127
whisper-small,generate,86,6,7,99,0.13131313131313127
GPT-4o mini Transcribe,march,86,12,1,99,0.13131313131313127
whisper-small,eps,172,9,17,198,0.13131313131313127
whisper-small,euro,656,57,42,755,0.1311258278145695
whisper-large-v3-turbo,pandemic,179,24,3,206,0.1310679611650486
whisper-small,outlook,199,21,9,229,0.13100436681222705
whisper-small,yen,1194,138,42,1374,0.13100436681222705
GPT-4o mini Transcribe,remain,100,6,9,115,0.13043478260869568
GPT-4o mini Transcribe,maturity,60,3,6,69,0.13043478260869568
whisper-large-v3-turbo,accounting,60,6,3,69,0.13043478260869568
whisper-large-v3-turbo,rose,120,15,3,138,0.13043478260869568
whisper-small,ex,60,6,3,69,0.13043478260869568
whisper-large-v3-turbo,enterprise,60,0,9,69,0.13043478260869568
whisper-large-v3-turbo,ex,60,6,3,69,0.13043478260869568
whisper-small,high,354,28,25,407,0.13022113022113024
whisper-small,totaled,127,19,0,146,0.13013698630136983
whisper-large-v3-turbo,benefit,87,9,4,100,0.13
whisper-large-v3-turbo,id,67,6,4,77,0.1298701298701299
whisper-small,ebitda,1838,171,103,2112,0.1297348484848485
whisper-small,reason,47,7,0,54,0.12962962962962965
whisper-large-v3-turbo,benefits,47,4,3,54,0.12962962962962965
GPT-4o mini Transcribe,environment,94,7,7,108,0.12962962962962965
GPT-4o mini Transcribe,benefits,47,7,0,54,0.12962962962962965
whisper-large-v3-turbo,day,336,29,21,386,0.1295336787564767
GPT-4o mini Transcribe,further,121,9,9,139,0.1294964028776978
whisper-small,recovery,121,15,3,139,0.1294964028776978
whisper-small,where,249,19,18,286,0.12937062937062938
whisper-large-v3-turbo,point,431,37,27,495,0.12929292929292935
GPT-4o mini Transcribe,vious,472,48,22,542,0.12915129151291516
whisper-small,orders,115,4,13,132,0.12878787878787878
whisper-large-v3-turbo,after,352,30,22,404,0.12871287128712872
whisper-large-v3-turbo,vious,474,43,27,544,0.12867647058823528
whisper-large-v3-turbo,joining,61,3,6,70,0.12857142857142856
whisper-large-v3-turbo,structure,61,9,0,70,0.12857142857142856
whisper-small,structure,61,9,0,70,0.12857142857142856
whisper-small,against,122,12,6,140,0.12857142857142856
whisper-large-v3-turbo,february,61,3,6,70,0.12857142857142856
whisper-large-v3-turbo,product,224,32,1,257,0.12840466926070038
whisper-small,committed,68,9,1,78,0.1282051282051282
whisper-small,still,306,22,23,351,0.1282051282051282
whisper-large-v3-turbo,without,75,4,7,86,0.12790697674418605
whisper-large-v3-turbo,capacity,150,19,3,172,0.12790697674418605
GPT-4o mini Transcribe,any,239,27,8,274,0.12773722627737227
whisper-small,any,246,28,8,282,0.12765957446808507
whisper-large-v3-turbo,lower,596,49,38,683,0.12737920937042457
whisper-small,actions,48,5,2,55,0.12727272727272732
GPT-4o mini Transcribe,bridge,48,1,6,55,0.12727272727272732
whisper-large-v3-turbo,impacts,48,0,7,55,0.12727272727272732
whisper-small,big,103,9,6,118,0.1271186440677966
whisper-large-v3-turbo,less,206,21,9,236,0.1271186440677966
whisper-large-v3-turbo,supported,103,6,9,118,0.1271186440677966
whisper-small,levels,275,25,15,315,0.12698412698412698
GPT-4o mini Transcribe,exceeding,62,6,3,71,0.12676056338028174
whisper-large-v3-turbo,exceeding,62,3,6,71,0.12676056338028174
GPT-4o mini Transcribe,china,62,6,3,71,0.12676056338028174
whisper-large-v3-turbo,range,496,55,17,568,0.12676056338028174
whisper-large-v3-turbo,important,131,12,7,150,0.1266666666666667
GPT-4o mini Transcribe,structure,69,9,1,79,0.12658227848101267
GPT-4o mini Transcribe,little,152,12,10,174,0.12643678160919536
GPT-4o mini Transcribe,fact,83,9,3,95,0.12631578947368416
whisper-small,colombia,83,9,3,95,0.12631578947368416
whisper-large-v3-turbo,improving,83,6,6,95,0.12631578947368416
whisper-small,environment,97,10,4,111,0.12612612612612617
whisper-large-v3-turbo,environment,97,12,2,111,0.12612612612612617
GPT-4o mini Transcribe,companys,111,9,7,127,0.12598425196850394
whisper-small,represented,118,10,7,135,0.12592592592592589
whisper-small,generation,153,16,6,175,0.12571428571428567
whisper-small,included,174,12,13,199,0.12562814070351758
GPT-4o mini Transcribe,positive,432,28,34,494,0.1255060728744939
whisper-small,us,1106,98,60,1264,0.125
whisper-small,economic,77,6,5,88,0.125
whisper-small,seen,231,18,15,264,0.125
GPT-4o mini Transcribe,reais,189,15,12,216,0.125
GPT-4o mini Transcribe,clear,84,3,9,96,0.125
whisper-small,fee,91,6,7,104,0.125
whisper-small,close,295,11,31,337,0.12462908011869434
whisper-small,like,478,33,35,546,0.12454212454212454
whisper-small,reached,367,33,19,419,0.12410501193317425
whisper-small,following,106,12,3,121,0.12396694214876036
whisper-small,explained,106,15,0,121,0.12396694214876036
whisper-small,thank,424,30,30,484,0.12396694214876036
whisper-small,volume,290,30,11,331,0.1238670694864048
whisper-large-v3-turbo,generated,270,27,11,308,0.12337662337662336
whisper-large-v3-turbo,target,249,25,10,284,0.12323943661971826
whisper-large-v3-turbo,companys,114,9,7,130,0.12307692307692308
whisper-small,mix,164,13,10,187,0.12299465240641716
whisper-small,least,107,3,12,122,0.12295081967213117
whisper-small,launched,50,3,4,57,0.1228070175438597
whisper-large-v3-turbo,bit,150,15,6,171,0.1228070175438597
whisper-small,core,251,24,11,286,0.1223776223776224
whisper-large-v3-turbo,acquired,122,12,5,139,0.12230215827338131
GPT-4o mini Transcribe,acquired,122,9,8,139,0.12230215827338131
whisper-small,expect,805,60,52,917,0.12213740458015265
whisper-small,decreased,417,39,19,475,0.12210526315789472
whisper-large-v3-turbo,below,259,24,12,295,0.12203389830508471
whisper-small,dont,108,9,6,123,0.12195121951219512
whisper-small,guidance,1347,87,100,1534,0.12190352020860495
whisper-large-v3-turbo,sheet,173,15,9,197,0.12182741116751272
whisper-small,right,289,21,19,329,0.12158054711246202
GPT-4o mini Transcribe,acquisition,181,7,18,206,0.12135922330097082
GPT-4o mini Transcribe,kroner,87,9,3,99,0.12121212121212122
whisper-small,inflation,109,7,8,124,0.12096774193548387
whisper-small,made,109,15,0,124,0.12096774193548387
whisper-small,end,815,48,64,927,0.12081984897518883
whisper-small,despite,204,13,15,232,0.12068965517241381
whisper-small,change,102,6,8,116,0.12068965517241381
whisper-small,base,248,29,5,282,0.12056737588652477
whisper-large-v3-turbo,markets,197,18,9,224,0.1205357142857143
whisper-large-v3-turbo,potential,73,10,0,83,0.12048192771084343
whisper-small,potential,73,9,1,83,0.12048192771084343
whisper-large-v3-turbo,okay,227,25,6,258,0.12015503875968991
whisper-large-v3-turbo,value,271,25,12,308,0.12012987012987009
whisper-small,dollars,396,25,29,450,0.12
whisper-large-v3-turbo,charge,66,3,6,75,0.12
whisper-large-v3-turbo,much,302,27,14,343,0.11953352769679304
whisper-small,asset,398,38,16,452,0.11946902654867253
GPT-4o mini Transcribe,general,118,7,9,134,0.11940298507462688
whisper-small,increase,1948,162,102,2212,0.11934900542495475
whisper-large-v3-turbo,yeah,244,16,17,277,0.11913357400722024
whisper-large-v3-turbo,policy,111,15,0,126,0.11904761904761907
whisper-large-v3-turbo,volume,289,27,12,328,0.11890243902439024
whisper-small,shows,126,7,10,143,0.11888111888111885
GPT-4o mini Transcribe,did,119,9,7,135,0.11851851851851847
GPT-4o mini Transcribe,working,253,13,21,287,0.11846689895470386
whisper-small,expectation,67,6,3,76,0.11842105263157898
whisper-large-v3-turbo,expectation,67,6,3,76,0.11842105263157898
whisper-large-v3-turbo,weve,410,39,16,465,0.11827956989247312
whisper-small,third,1424,136,55,1615,0.11826625386996903
GPT-4o mini Transcribe,fee,97,3,10,110,0.11818181818181817
whisper-large-v3-turbo,fee,97,6,7,110,0.11818181818181817
whisper-large-v3-turbo,billion,4400,420,169,4989,0.11805973140909998
whisper-small,period,770,62,41,873,0.11798396334478811
GPT-4o mini Transcribe,less,202,21,6,229,0.11790393013100442
whisper-small,excluding,337,29,16,382,0.11780104712041883
whisper-small,assumption,45,0,6,51,0.11764705882352944
whisper-large-v3-turbo,corresponding,75,6,4,85,0.11764705882352944
GPT-4o mini Transcribe,grown,45,6,0,51,0.11764705882352944
whisper-large-v3-turbo,recent,45,1,5,51,0.11764705882352944
whisper-large-v3-turbo,overall,375,30,20,425,0.11764705882352944
whisper-small,corresponding,75,7,3,85,0.11764705882352944
whisper-large-v3-turbo,penetration,45,6,0,51,0.11764705882352944
whisper-small,grown,45,6,0,51,0.11764705882352944
GPT-4o mini Transcribe,variance,45,3,3,51,0.11764705882352944
whisper-large-v3-turbo,cumulative,45,0,6,51,0.11764705882352944
GPT-4o mini Transcribe,fy21,90,12,0,102,0.11764705882352944
whisper-small,recent,45,1,5,51,0.11764705882352944
whisper-large-v3-turbo,guidance,1358,110,71,1539,0.11760883690708257
whisper-small,level,488,45,20,553,0.11754068716094035
whisper-small,second,849,64,49,962,0.11746361746361744
whisper-large-v3-turbo,stable,128,14,3,145,0.11724137931034484
whisper-small,key,181,21,3,205,0.11707317073170731
whisper-small,low,257,18,16,291,0.11683848797250862
whisper-small,result,514,39,29,582,0.11683848797250862
whisper-large-v3-turbo,quite,121,9,7,137,0.11678832116788318
whisper-small,cash,2744,230,132,3106,0.1165486155827431
whisper-small,fourth,614,53,28,695,0.11654676258992802
whisper-small,maintain,91,9,3,103,0.11650485436893199
GPT-4o mini Transcribe,maintain,91,6,6,103,0.11650485436893199
whisper-small,paid,190,19,6,215,0.11627906976744184
GPT-4o mini Transcribe,point,442,29,29,500,0.11599999999999999
whisper-small,million,8751,749,399,9899,0.11597131023335694
whisper-small,based,290,30,8,328,0.11585365853658536
whisper-large-v3-turbo,recurring,145,17,2,164,0.11585365853658536
whisper-small,negative,283,34,3,320,0.11562499999999998
whisper-small,delivered,199,15,11,225,0.11555555555555552
GPT-4o mini Transcribe,złoty,69,6,3,78,0.11538461538461542
whisper-small,build,69,9,0,78,0.11538461538461542
whisper-large-v3-turbo,want,69,6,3,78,0.11538461538461542
whisper-small,amounting,46,3,3,52,0.11538461538461542
whisper-small,evolution,115,6,9,130,0.11538461538461542
whisper-large-v3-turbo,q1,368,39,9,416,0.11538461538461542
GPT-4o mini Transcribe,obviously,299,30,9,338,0.11538461538461542
whisper-large-v3-turbo,złoty,69,6,3,78,0.11538461538461542
whisper-small,lead,46,3,3,52,0.11538461538461542
GPT-4o mini Transcribe,board,115,9,6,130,0.11538461538461542
GPT-4o mini Transcribe,mix,169,18,4,191,0.11518324607329844
whisper-small,fees,169,15,7,191,0.11518324607329844
whisper-small,compared,2013,176,86,2275,0.11516483516483511
whisper-small,inventory,54,6,1,61,0.11475409836065575
whisper-small,annualized,54,3,4,61,0.11475409836065575
whisper-large-v3-turbo,prices,193,16,9,218,0.11467889908256879
GPT-4o mini Transcribe,announced,139,15,3,157,0.1146496815286624
whisper-small,said,278,30,6,314,0.1146496815286624
whisper-small,effective,170,12,10,192,0.11458333333333337
whisper-small,improve,116,6,9,131,0.1145038167938931
GPT-4o mini Transcribe,depreciation,93,3,9,105,0.11428571428571432
GPT-4o mini Transcribe,volume,287,21,16,324,0.11419753086419748
GPT-4o mini Transcribe,theres,101,7,6,114,0.11403508771929827
whisper-small,liability,70,9,0,79,0.11392405063291144
whisper-small,payment,140,12,6,158,0.11392405063291144
GPT-4o mini Transcribe,too,70,6,3,79,0.11392405063291144
whisper-large-v3-turbo,based,288,27,10,325,0.11384615384615382
GPT-4o mini Transcribe,selling,109,11,3,123,0.11382113821138207
whisper-small,selling,109,10,4,123,0.11382113821138207
GPT-4o mini Transcribe,remains,148,16,3,167,0.11377245508982037
GPT-4o mini Transcribe,billion,4421,406,161,4988,0.11367281475541302
GPT-4o mini Transcribe,represents,164,12,9,185,0.11351351351351346
whisper-large-v3-turbo,decreased,422,38,16,476,0.11344537815126055
GPT-4o mini Transcribe,result,508,24,41,573,0.11343804537521818
whisper-small,both,313,30,10,353,0.11331444759206799
whisper-large-v3-turbo,compound,47,6,0,53,0.1132075471698113
GPT-4o mini Transcribe,incremental,94,6,6,106,0.1132075471698113
GPT-4o mini Transcribe,use,94,9,3,106,0.1132075471698113
whisper-large-v3-turbo,use,94,9,3,106,0.1132075471698113
GPT-4o mini Transcribe,todays,47,6,0,53,0.1132075471698113
GPT-4o mini Transcribe,actual,47,6,0,53,0.1132075471698113
whisper-small,reflects,94,12,0,106,0.1132075471698113
GPT-4o mini Transcribe,reflects,94,0,12,106,0.1132075471698113
whisper-large-v3-turbo,execution,47,3,3,53,0.1132075471698113
whisper-small,probably,102,10,3,115,0.11304347826086958
whisper-small,reach,157,15,5,177,0.11299435028248583
GPT-4o mini Transcribe,long,212,22,5,239,0.11297071129707115
whisper-large-v3-turbo,price,1029,83,48,1160,0.11293103448275865
whisper-small,summary,55,0,7,62,0.11290322580645162
whisper-large-v3-turbo,pleased,55,3,4,62,0.11290322580645162
whisper-large-v3-turbo,tl,189,18,6,213,0.11267605633802813
GPT-4o mini Transcribe,bottom,63,7,1,71,0.11267605633802813
whisper-small,below,260,24,9,293,0.11262798634812288
whisper-small,infrastructure,71,3,6,80,0.11250000000000004
GPT-4o mini Transcribe,potential,71,9,0,80,0.11250000000000004
whisper-small,bringing,71,9,0,80,0.11250000000000004
whisper-large-v3-turbo,yield,71,6,3,80,0.11250000000000004
GPT-4o mini Transcribe,31st,87,0,11,98,0.11224489795918369
whisper-small,energy,182,6,17,205,0.1121951219512195
whisper-small,significant,380,33,15,428,0.11214953271028039
whisper-small,strong,998,86,40,1124,0.1120996441281139
whisper-large-v3-turbo,led,103,9,4,116,0.11206896551724133
whisper-small,remain,103,3,10,116,0.11206896551724133
GPT-4o mini Transcribe,reach,159,15,5,179,0.11173184357541899
whisper-small,september,342,30,13,385,0.11168831168831173
whisper-large-v3-turbo,thank,430,33,21,484,0.11157024793388426
GPT-4o mini Transcribe,under,239,21,9,269,0.11152416356877326
whisper-large-v3-turbo,very,933,69,48,1050,0.11142857142857143
GPT-4o mini Transcribe,small,56,0,7,63,0.11111111111111116
GPT-4o mini Transcribe,turkish,72,9,0,81,0.11111111111111116
whisper-large-v3-turbo,though,48,3,3,54,0.11111111111111116
whisper-small,wanted,48,6,0,54,0.11111111111111116
whisper-small,whether,48,3,3,54,0.11111111111111116
GPT-4o mini Transcribe,wanted,48,6,0,54,0.11111111111111116
whisper-small,taxes,120,0,15,135,0.11111111111111116
whisper-large-v3-turbo,trends,48,6,0,54,0.11111111111111116
whisper-large-v3-turbo,give,176,13,9,198,0.11111111111111116
whisper-small,roce,48,0,6,54,0.11111111111111116
whisper-small,assets,216,16,11,243,0.11111111111111116
whisper-small,alone,72,6,3,81,0.11111111111111116
whisper-small,zero,144,10,8,162,0.11111111111111116
whisper-large-v3-turbo,figures,144,12,6,162,0.11111111111111116
whisper-small,drivers,128,16,0,144,0.11111111111111116
whisper-large-v3-turbo,wanted,48,6,0,54,0.11111111111111116
whisper-large-v3-turbo,scope,48,3,3,54,0.11111111111111116
whisper-large-v3-turbo,reais,192,15,9,216,0.11111111111111116
whisper-small,bookings,48,0,6,54,0.11111111111111116
whisper-large-v3-turbo,sonae,48,6,0,54,0.11111111111111116
whisper-small,or,1494,116,70,1680,0.11071428571428577
whisper-small,roughly,225,16,12,253,0.11067193675889331
GPT-4o mini Transcribe,revenues,571,46,25,642,0.11059190031152644
GPT-4o mini Transcribe,able,113,9,5,127,0.11023622047244097
whisper-small,these,565,46,24,635,0.11023622047244097
GPT-4o mini Transcribe,supported,97,6,6,109,0.11009174311926606
whisper-large-v3-turbo,low,259,25,7,291,0.10996563573883167
GPT-4o mini Transcribe,they,170,18,3,191,0.10994764397905754
whisper-small,put,73,8,1,82,0.1097560975609756
GPT-4o mini Transcribe,particularly,73,6,3,82,0.1097560975609756
whisper-small,good,480,41,18,539,0.10946196660482377
whisper-small,flow,1018,65,60,1143,0.10936132983377078
whisper-large-v3-turbo,able,106,9,4,119,0.10924369747899154
whisper-small,additional,155,4,15,174,0.10919540229885061
whisper-small,rates,204,14,11,229,0.10917030567685593
GPT-4o mini Transcribe,clearly,98,9,3,110,0.10909090909090913
whisper-small,commerce,49,6,0,55,0.10909090909090913
whisper-large-v3-turbo,recovering,49,0,6,55,0.10909090909090913
whisper-large-v3-turbo,conditions,49,1,5,55,0.10909090909090913
whisper-small,might,49,6,0,55,0.10909090909090913
whisper-large-v3-turbo,lost,49,6,0,55,0.10909090909090913
whisper-small,performance,613,51,24,688,0.10901162790697672
whisper-small,thanks,188,13,10,211,0.1090047393364929
whisper-small,is,5947,473,254,6674,0.10893017680551398
whisper-small,loans,131,6,10,147,0.108843537414966
whisper-small,expenses,1041,69,58,1168,0.10873287671232879
GPT-4o mini Transcribe,rose,123,12,3,138,0.10869565217391308
whisper-small,rose,123,15,0,138,0.10869565217391308
GPT-4o mini Transcribe,weve,410,28,22,460,0.10869565217391308
whisper-large-v3-turbo,q3,640,50,28,718,0.10863509749303624
whisper-small,towards,107,6,7,120,0.10833333333333328
GPT-4o mini Transcribe,towards,107,9,4,120,0.10833333333333328
whisper-small,capital,1452,131,45,1628,0.10810810810810811
whisper-small,its,1181,87,56,1324,0.10800604229607247
whisper-large-v3-turbo,further,124,12,3,139,0.1079136690647482
whisper-small,annual,488,31,28,547,0.10786106032906762
whisper-small,equity,546,50,16,612,0.10784313725490191
whisper-small,production,398,27,21,446,0.1076233183856502
whisper-small,almost,332,21,19,372,0.10752688172043012
whisper-large-v3-turbo,sold,108,10,3,121,0.1074380165289256
whisper-large-v3-turbo,right,291,26,9,326,0.1073619631901841
whisper-small,software,100,12,0,112,0.1071428571428571
whisper-small,user,75,9,0,84,0.1071428571428571
whisper-small,let,175,15,6,196,0.1071428571428571
whisper-small,income,1950,170,64,2184,0.1071428571428571
whisper-large-v3-turbo,included,175,6,15,196,0.1071428571428571
whisper-small,todays,50,6,0,56,0.1071428571428571
whisper-small,hi,50,3,3,56,0.1071428571428571
whisper-small,h1,150,15,3,168,0.1071428571428571
whisper-large-v3-turbo,clearly,100,12,0,112,0.1071428571428571
whisper-large-v3-turbo,consolidated,234,18,10,262,0.10687022900763354
whisper-large-v3-turbo,income,1948,168,65,2181,0.10683172856487855
whisper-small,acquisition,184,13,9,206,0.10679611650485432
whisper-small,volumes,159,13,6,178,0.1067415730337079
whisper-small,30th,67,8,0,75,0.10666666666666669
GPT-4o mini Transcribe,continuing,67,6,2,75,0.10666666666666669
whisper-small,now,1156,96,42,1294,0.10664605873261201
whisper-large-v3-turbo,euro,680,42,39,761,0.10643889618922475
whisper-large-v3-turbo,addition,168,8,12,188,0.1063829787234043
GPT-4o mini Transcribe,june,185,14,8,207,0.106280193236715
whisper-small,expansion,202,17,7,226,0.10619469026548678
whisper-small,loss,362,25,18,405,0.10617283950617284
whisper-large-v3-turbo,focused,59,0,7,66,0.10606060606060608
GPT-4o mini Transcribe,focused,59,0,7,66,0.10606060606060608
whisper-small,half,649,43,34,726,0.10606060606060608
whisper-small,focused,59,0,7,66,0.10606060606060608
GPT-4o mini Transcribe,target,253,19,11,283,0.10600706713780916
GPT-4o mini Transcribe,bit,152,12,6,170,0.10588235294117643
whisper-large-v3-turbo,worth,76,3,6,85,0.10588235294117643
whisper-small,primarily,245,15,14,274,0.1058394160583942
whisper-small,markets,203,21,3,227,0.10572687224669608
whisper-small,gain,110,3,10,123,0.10569105691056913
whisper-small,would,677,53,27,757,0.10568031704095115
whisper-large-v3-turbo,like,491,36,22,549,0.10564663023679421
GPT-4o mini Transcribe,price,1016,60,60,1136,0.10563380281690138
GPT-4o mini Transcribe,product,229,27,0,256,0.10546875
whisper-small,at,4072,283,197,4552,0.10544815465729351
whisper-small,digit,187,6,16,209,0.10526315789473684
GPT-4o mini Transcribe,remind,51,6,0,57,0.10526315789473684
whisper-large-v3-turbo,gains,153,10,8,171,0.10526315789473684
whisper-small,it,1445,94,76,1615,0.10526315789473684
whisper-small,bit,153,15,3,171,0.10526315789473684
whisper-large-v3-turbo,decided,51,3,3,57,0.10526315789473684
GPT-4o mini Transcribe,additional,145,4,13,162,0.1049382716049383
whisper-large-v3-turbo,both,316,27,10,353,0.10481586402266285
whisper-small,of,20184,1466,897,22547,0.10480329977380587
whisper-large-v3-turbo,levels,282,24,9,315,0.10476190476190472
GPT-4o mini Transcribe,unchanged,77,6,3,86,0.10465116279069764
whisper-small,without,77,4,5,86,0.10465116279069764
whisper-small,around,1155,81,54,1290,0.10465116279069764
whisper-large-v3-turbo,fees,163,15,4,182,0.10439560439560436
whisper-large-v3-turbo,around,1141,79,54,1274,0.10439560439560436
whisper-small,balance,292,31,3,326,0.10429447852760731
whisper-large-v3-turbo,why,129,6,9,144,0.10416666666666663
whisper-small,thats,757,66,22,845,0.10414201183431948
whisper-small,underlying,250,12,17,279,0.10394265232974909
whisper-large-v3-turbo,adjusted,1329,72,82,1483,0.10384356035064057
whisper-large-v3-turbo,loss,363,32,10,405,0.10370370370370374
whisper-small,okay,234,18,9,261,0.10344827586206895
GPT-4o mini Transcribe,never,52,3,3,58,0.10344827586206895
GPT-4o mini Transcribe,seen,234,3,24,261,0.10344827586206895
GPT-4o mini Transcribe,synergies,52,3,3,58,0.10344827586206895
whisper-small,pay,78,3,6,87,0.10344827586206895
whisper-large-v3-turbo,remain,104,7,5,116,0.10344827586206895
whisper-small,reduced,139,4,12,155,0.10322580645161294
whisper-small,terms,617,48,23,688,0.10319767441860461
whisper-large-v3-turbo,clear,87,3,7,97,0.1030927835051546
GPT-4o mini Transcribe,momentum,87,3,7,97,0.1030927835051546
whisper-small,rd,183,18,3,204,0.1029411764705882
GPT-4o mini Transcribe,operational,96,6,5,107,0.10280373831775702
whisper-large-v3-turbo,equity,550,50,13,613,0.10277324632952689
whisper-small,better,227,10,16,253,0.1027667984189723
whisper-small,net,3524,272,131,3927,0.1026228673287497
whisper-large-v3-turbo,tty,114,10,3,127,0.10236220472440949
whisper-small,last,1842,125,85,2052,0.10233918128654973
whisper-small,average,614,37,33,684,0.10233918128654973
whisper-large-v3-turbo,seen,237,12,15,264,0.10227272727272729
whisper-large-v3-turbo,tier,79,6,3,88,0.10227272727272729
whisper-large-v3-turbo,sent,79,6,3,88,0.10227272727272729
whisper-small,quite,123,8,6,137,0.1021897810218978
whisper-large-v3-turbo,third,1450,112,53,1615,0.10216718266253866
whisper-large-v3-turbo,momentum,88,9,1,98,0.10204081632653061
whisper-small,quarter,6073,432,257,6762,0.1018929310854777
whisper-small,estimate,203,13,10,226,0.10176991150442483
whisper-small,rmb,203,14,9,226,0.10176991150442483
GPT-4o mini Transcribe,improvements,53,6,0,59,0.10169491525423724
whisper-small,retention,53,3,3,59,0.10169491525423724
whisper-large-v3-turbo,making,53,3,3,59,0.10169491525423724
whisper-small,progress,53,3,3,59,0.10169491525423724
whisper-small,making,53,3,3,59,0.10169491525423724
GPT-4o mini Transcribe,comment,53,6,0,59,0.10169491525423724
GPT-4o mini Transcribe,thing,53,6,0,59,0.10169491525423724
GPT-4o mini Transcribe,addition,168,6,13,187,0.10160427807486627
whisper-large-v3-turbo,better,230,16,10,256,0.1015625
whisper-large-v3-turbo,lot,62,3,4,69,0.10144927536231885
whisper-large-v3-turbo,foreign,62,3,4,69,0.10144927536231885
whisper-small,foreign,62,3,4,69,0.10144927536231885
whisper-small,regarding,186,12,9,207,0.10144927536231885
whisper-small,market,604,36,32,672,0.10119047619047616
whisper-small,pre,1519,110,61,1690,0.10118343195266277
GPT-4o mini Transcribe,income,1937,165,53,2155,0.10116009280742455
GPT-4o mini Transcribe,currently,80,6,3,89,0.101123595505618
whisper-small,again,347,15,24,386,0.10103626943005184
whisper-large-v3-turbo,will,1326,82,67,1475,0.10101694915254233
whisper-small,side,178,16,4,198,0.101010101010101
whisper-small,quarters,267,24,6,297,0.101010101010101
whisper-small,to,16774,1173,708,18655,0.10083087644063249
GPT-4o mini Transcribe,taxes,116,1,12,129,0.10077519379844957
whisper-large-v3-turbo,recorded,241,18,9,268,0.10074626865671643
whisper-large-v3-turbo,company,250,15,13,278,0.1007194244604317
whisper-small,when,456,42,9,507,0.10059171597633132
whisper-large-v3-turbo,only,304,18,16,338,0.10059171597633132
whisper-small,not,671,42,33,746,0.10053619302949057
whisper-large-v3-turbo,effective,170,18,1,189,0.10052910052910058
whisper-small,achieved,179,12,8,199,0.10050251256281406
whisper-small,start,179,11,9,199,0.10050251256281406
whisper-small,lower,618,29,40,687,0.10043668122270744
whisper-small,operations,251,15,13,279,0.10035842293906805
whisper-small,moving,314,24,11,349,0.10028653295128942
whisper-small,midpoint,54,6,0,60,0.09999999999999998
whisper-small,isas,54,6,0,60,0.09999999999999998
whisper-small,portion,54,3,3,60,0.09999999999999998
GPT-4o mini Transcribe,isas,54,6,0,60,0.09999999999999998
whisper-large-v3-turbo,construction,81,3,6,90,0.09999999999999998
GPT-4o mini Transcribe,whats,54,6,0,60,0.09999999999999998
whisper-small,accounts,99,9,2,110,0.09999999999999998
whisper-large-v3-turbo,billings,54,0,6,60,0.09999999999999998
whisper-small,maintenance,81,0,9,90,0.09999999999999998
whisper-large-v3-turbo,strategy,108,9,3,120,0.09999999999999998
whisper-large-v3-turbo,june,189,12,9,210,0.09999999999999998
whisper-large-v3-turbo,midpoint,54,3,3,60,0.09999999999999998
whisper-large-v3-turbo,remember,54,3,3,60,0.09999999999999998
whisper-small,pricing,90,10,0,100,0.09999999999999998
whisper-large-v3-turbo,reached,388,31,12,431,0.09976798143851506
whisper-small,expected,587,47,18,652,0.09969325153374231
whisper-small,the,29621,2184,1091,32896,0.09955617704280151
whisper-small,earlier,181,6,14,201,0.09950248756218905
whisper-large-v3-turbo,earlier,181,6,14,201,0.09950248756218905
whisper-small,numbers,172,13,6,191,0.09947643979057597
whisper-small,will,1331,92,55,1478,0.09945872801082545
whisper-large-v3-turbo,still,317,27,8,352,0.09943181818181823
whisper-small,representing,308,27,7,342,0.09941520467836262
whisper-small,hand,145,12,4,161,0.0993788819875776
whisper-small,continue,372,33,8,413,0.09927360774818406
GPT-4o mini Transcribe,compared,2025,123,100,2248,0.09919928825622781
GPT-4o mini Transcribe,ended,173,11,8,192,0.09895833333333337
whisper-small,what,674,54,20,748,0.09893048128342241
whisper-large-v3-turbo,currently,82,6,3,91,0.09890109890109888
GPT-4o mini Transcribe,beginning,82,6,3,91,0.09890109890109888
whisper-small,want,73,8,0,81,0.09876543209876543
whisper-small,stable,128,11,3,142,0.09859154929577463
whisper-large-v3-turbo,january,64,6,1,71,0.09859154929577463
whisper-small,unit,293,26,6,325,0.09846153846153849
whisper-small,synergies,55,3,3,61,0.09836065573770492
whisper-small,provide,55,3,3,61,0.09836065573770492
whisper-small,cap,55,6,0,61,0.09836065573770492
whisper-small,those,275,21,9,305,0.09836065573770492
whisper-large-v3-turbo,us,1137,78,46,1261,0.09833465503568595
whisper-large-v3-turbo,expenses,1056,67,48,1171,0.09820666097352693
whisper-small,same,597,49,16,662,0.09818731117824775
GPT-4o mini Transcribe,their,147,13,3,163,0.09815950920245398
whisper-small,past,147,13,3,163,0.09815950920245398
whisper-small,their,147,7,9,163,0.09815950920245398
whisper-large-v3-turbo,past,147,10,6,163,0.09815950920245398
whisper-small,course,193,9,12,214,0.09813084112149528
whisper-small,make,92,9,1,102,0.0980392156862745
whisper-small,financial,497,32,22,551,0.09800362976406529
whisper-large-v3-turbo,september,350,21,17,388,0.09793814432989689
whisper-small,currently,83,6,3,92,0.09782608695652173
whisper-large-v3-turbo,note,83,6,3,92,0.09782608695652173
whisper-small,april,83,6,3,92,0.09782608695652173
whisper-small,note,83,6,3,92,0.09782608695652173
GPT-4o mini Transcribe,sentation,83,6,3,92,0.09782608695652173
whisper-small,sentation,83,6,3,92,0.09782608695652173
whisper-large-v3-turbo,given,249,27,0,276,0.09782608695652173
whisper-large-v3-turbo,sentation,83,6,3,92,0.09782608695652173
whisper-large-v3-turbo,dollars,406,28,16,450,0.09777777777777774
whisper-large-v3-turbo,fiscal,997,65,43,1105,0.09773755656108596
whisper-large-v3-turbo,management,231,24,1,256,0.09765625
whisper-large-v3-turbo,came,268,17,12,297,0.09764309764309764
whisper-small,gmv,111,12,0,123,0.09756097560975607
whisper-large-v3-turbo,put,74,7,1,82,0.09756097560975607
whisper-small,effects,74,8,0,82,0.09756097560975607
whisper-large-v3-turbo,dont,111,9,3,123,0.09756097560975607
GPT-4o mini Transcribe,hand,148,15,1,164,0.09756097560975607
whisper-small,give,176,7,12,195,0.09743589743589742
whisper-small,a,9255,588,411,10254,0.09742539496781744
whisper-large-v3-turbo,rmb,204,12,10,226,0.09734513274336287
whisper-large-v3-turbo,asset,408,29,15,452,0.09734513274336287
whisper-large-v3-turbo,represents,167,15,3,185,0.0972972972972973
whisper-small,product,232,18,7,257,0.09727626459143968
whisper-large-v3-turbo,an,2079,99,125,2303,0.09726443768996962
whisper-large-v3-turbo,30th,65,6,1,72,0.09722222222222221
whisper-large-v3-turbo,reflecting,158,13,4,175,0.0971428571428572
whisper-small,out,409,14,30,453,0.09713024282560712
whisper-large-v3-turbo,compared,2046,128,92,2266,0.09708737864077666
whisper-large-v3-turbo,energy,177,1,18,196,0.09693877551020413
whisper-small,you,3579,241,143,3963,0.09689629068887207
whisper-small,please,317,24,10,351,0.09686609686609682
whisper-large-v3-turbo,planning,56,0,6,62,0.09677419354838712
whisper-large-v3-turbo,step,84,9,0,93,0.09677419354838712
whisper-small,break,56,0,6,62,0.09677419354838712
whisper-small,planning,56,0,6,62,0.09677419354838712
whisper-large-v3-turbo,voice,84,6,3,93,0.09677419354838712
GPT-4o mini Transcribe,decreased,411,31,13,455,0.09670329670329669
whisper-small,call,327,7,28,362,0.09668508287292821
whisper-small,we,7816,481,355,8652,0.09662505779010633
GPT-4o mini Transcribe,out,412,14,30,456,0.0964912280701754
whisper-large-v3-turbo,finally,150,15,1,166,0.09638554216867468
whisper-small,with,4004,254,173,4431,0.0963665086887836
whisper-small,year,8403,564,332,9299,0.0963544467147005
whisper-small,operation,122,6,7,135,0.09629629629629632
whisper-small,specific,47,5,0,52,0.09615384615384615
whisper-large-v3-turbo,specific,47,5,0,52,0.09615384615384615
whisper-small,group,536,33,24,593,0.09612141652613826
GPT-4o mini Transcribe,september,348,27,10,385,0.09610389610389614
whisper-small,because,339,33,3,375,0.09599999999999997
whisper-small,fiscal,999,69,37,1105,0.09592760180995474
whisper-small,new,509,40,14,563,0.0959147424511545
whisper-small,tier,85,6,3,94,0.0957446808510638
whisper-small,comes,123,13,0,136,0.09558823529411764
whisper-large-v3-turbo,revenues,587,48,14,649,0.09553158705701081
whisper-small,euros,1070,76,37,1183,0.09551986475063401
whisper-small,turning,161,7,10,178,0.0955056179775281
whisper-small,no,199,9,12,220,0.09545454545454546
whisper-small,customers,95,7,3,105,0.09523809523809523
whisper-small,lines,57,6,0,63,0.09523809523809523
GPT-4o mini Transcribe,stack,57,6,0,63,0.09523809523809523
GPT-4o mini Transcribe,details,57,6,0,63,0.09523809523809523
whisper-large-v3-turbo,customers,95,4,6,105,0.09523809523809523
GPT-4o mini Transcribe,joining,57,0,6,63,0.09523809523809523
GPT-4o mini Transcribe,loss,361,23,15,399,0.09523809523809523
whisper-small,talked,57,0,6,63,0.09523809523809523
whisper-large-v3-turbo,lines,57,3,3,63,0.09523809523809523
whisper-small,starting,95,9,1,105,0.09523809523809523
whisper-large-v3-turbo,stack,57,6,0,63,0.09523809523809523
GPT-4o mini Transcribe,lines,57,3,3,63,0.09523809523809523
whisper-large-v3-turbo,breakdown,57,3,3,63,0.09523809523809523
whisper-small,ago,266,25,3,294,0.09523809523809523
whisper-small,stack,57,6,0,63,0.09523809523809523
whisper-small,adjusted,1331,72,68,1471,0.09517335146159078
whisper-small,free,599,33,30,662,0.095166163141994
whisper-small,know,1009,73,33,1115,0.09506726457399106
GPT-4o mini Transcribe,euro,686,30,42,758,0.0949868073878628
whisper-small,only,305,18,14,337,0.09495548961424327
GPT-4o mini Transcribe,payout,143,9,6,158,0.09493670886075944
whisper-large-v3-turbo,reduced,143,4,11,158,0.09493670886075944
whisper-small,purchase,105,8,3,116,0.09482758620689657
whisper-small,by,4413,284,178,4875,0.09476923076923072
whisper-small,improving,86,9,0,95,0.09473684210526312
whisper-small,fact,86,9,0,95,0.09473684210526312
GPT-4o mini Transcribe,power,86,9,0,95,0.09473684210526312
whisper-small,finally,153,15,1,169,0.09467455621301779
whisper-small,investment,220,11,12,243,0.09465020576131689
whisper-small,sustainable,67,0,7,74,0.09459459459459463
GPT-4o mini Transcribe,id,67,6,1,74,0.09459459459459463
whisper-small,retail,115,6,6,127,0.09448818897637801
whisper-large-v3-turbo,those,278,15,14,307,0.09446254071661242
GPT-4o mini Transcribe,important,144,3,12,159,0.09433962264150941
GPT-4o mini Transcribe,quality,48,4,1,53,0.09433962264150941
GPT-4o mini Transcribe,again,346,27,9,382,0.09424083769633507
GPT-4o mini Transcribe,side,173,13,5,191,0.09424083769633507
whisper-large-v3-turbo,second,866,36,54,956,0.09414225941422594
whisper-large-v3-turbo,project,77,4,4,85,0.09411764705882353
whisper-large-v3-turbo,remains,154,12,4,170,0.09411764705882353
whisper-small,being,212,15,7,234,0.09401709401709402
GPT-4o mini Transcribe,assets,212,12,10,234,0.09401709401709402
whisper-small,increasing,241,13,12,266,0.09398496240601506
whisper-small,really,241,11,14,266,0.09398496240601506
whisper-small,above,434,28,17,479,0.09394572025052195
GPT-4o mini Transcribe,dollars,386,18,22,426,0.0938967136150235
whisper-small,capex,251,4,22,277,0.09386281588447654
whisper-large-v3-turbo,few,87,3,6,96,0.09375
whisper-small,achieve,87,0,9,96,0.09375
whisper-large-v3-turbo,private,87,9,0,96,0.09375
whisper-small,money,87,6,3,96,0.09375
GPT-4o mini Transcribe,middle,58,0,6,64,0.09375
whisper-large-v3-turbo,largest,58,3,3,64,0.09375
GPT-4o mini Transcribe,achieve,87,0,9,96,0.09375
whisper-large-v3-turbo,money,87,9,0,96,0.09375
whisper-large-v3-turbo,capital,1471,102,50,1623,0.09365372766481828
whisper-large-v3-turbo,period,794,49,33,876,0.09360730593607303
whisper-small,common,68,3,4,75,0.09333333333333338
whisper-small,overall,379,26,13,418,0.09330143540669855
GPT-4o mini Transcribe,much,311,6,26,343,0.09329446064139946
whisper-large-v3-turbo,good,486,31,19,536,0.09328358208955223
whisper-small,were,1830,110,78,2018,0.09316154608523286
whisper-small,final,78,4,4,86,0.09302325581395354
whisper-small,for,7293,454,294,8041,0.09302325581395354
whisper-small,increased,1504,99,55,1658,0.0928829915560917
GPT-4o mini Transcribe,payment,127,9,4,140,0.09285714285714286
whisper-large-v3-turbo,thats,772,47,32,851,0.09283196239717983
whisper-small,mostly,88,6,3,97,0.09278350515463918
GPT-4o mini Transcribe,zero,147,11,4,162,0.09259259259259256
whisper-large-v3-turbo,zero,147,8,7,162,0.09259259259259256
whisper-small,mobile,147,12,3,162,0.09259259259259256
whisper-large-v3-turbo,mobile,147,15,0,162,0.09259259259259256
whisper-large-v3-turbo,mentioned,304,15,16,335,0.09253731343283578
whisper-small,ahead,157,12,4,173,0.09248554913294793
whisper-large-v3-turbo,ahead,157,9,7,173,0.09248554913294793
GPT-4o mini Transcribe,tty,118,3,9,130,0.09230769230769231
whisper-small,number,472,20,28,520,0.09230769230769231
whisper-large-v3-turbo,evolution,118,9,3,130,0.09230769230769231
whisper-large-v3-turbo,side,177,14,4,195,0.09230769230769231
whisper-small,coverage,59,3,3,65,0.09230769230769231
GPT-4o mini Transcribe,primarily,246,9,16,271,0.09225092250922506
whisper-small,maturity,69,4,3,76,0.09210526315789469
GPT-4o mini Transcribe,stronger,69,3,4,76,0.09210526315789469
whisper-small,interest,493,37,13,543,0.09208103130755063
whisper-large-v3-turbo,let,178,15,3,196,0.09183673469387754
whisper-small,time,445,31,14,490,0.09183673469387754
whisper-large-v3-turbo,mostly,89,9,0,98,0.09183673469387754
GPT-4o mini Transcribe,let,178,15,3,196,0.09183673469387754
whisper-small,cost,1810,83,100,1993,0.0918213748118415
whisper-large-v3-turbo,net,3546,224,134,3904,0.09170081967213117
whisper-large-v3-turbo,ebitda,1923,124,70,2117,0.09163911195087393
GPT-4o mini Transcribe,conference,119,0,12,131,0.09160305343511455
GPT-4o mini Transcribe,tons,119,0,12,131,0.09160305343511455
whisper-large-v3-turbo,improve,119,6,6,131,0.09160305343511455
whisper-large-v3-turbo,increase,2004,112,90,2206,0.09156844968268363
whisper-large-v3-turbo,contributed,129,7,6,142,0.09154929577464788
whisper-large-v3-turbo,generation,159,12,4,175,0.09142857142857141
whisper-large-v3-turbo,been,607,35,26,668,0.0913173652694611
whisper-small,as,3246,194,132,3572,0.09126539753639418
whisper-large-v3-turbo,it,1465,88,59,1612,0.09119106699751856
whisper-small,looking,309,25,6,340,0.0911764705882353
whisper-large-v3-turbo,high,369,30,7,406,0.09113300492610843
whisper-large-v3-turbo,when,469,22,25,516,0.09108527131782951
whisper-small,well,749,44,31,824,0.09101941747572817
whisper-small,this,3767,205,172,4144,0.09097490347490345
whisper-small,questions,200,13,7,220,0.09090909090909094
whisper-large-v3-turbo,conference,120,6,6,132,0.09090909090909094
whisper-small,losses,60,3,3,66,0.09090909090909094
whisper-large-v3-turbo,losses,60,3,3,66,0.09090909090909094
GPT-4o mini Transcribe,such,80,3,5,88,0.09090909090909094
whisper-small,greater,60,3,3,66,0.09090909090909094
whisper-large-v3-turbo,advances,60,0,6,66,0.09090909090909094
whisper-small,gigawatts,60,0,6,66,0.09090909090909094
whisper-small,times,390,21,18,429,0.09090909090909094
whisper-large-v3-turbo,operation,120,9,3,132,0.09090909090909094
whisper-small,conference,120,3,9,132,0.09090909090909094
GPT-4o mini Transcribe,expanded,60,6,0,66,0.09090909090909094
GPT-4o mini Transcribe,talk,70,1,6,77,0.09090909090909094
whisper-small,can,601,43,17,661,0.0907715582450832
whisper-large-v3-turbo,improved,321,7,25,353,0.09065155807365444
GPT-4o mini Transcribe,recorded,241,15,9,265,0.09056603773584904
whisper-large-v3-turbo,related,442,8,36,486,0.09053497942386834
GPT-4o mini Transcribe,based,312,15,16,343,0.09037900874635574
GPT-4o mini Transcribe,barrels,151,12,3,166,0.09036144578313254
whisper-small,which,2239,120,102,2461,0.09020723283218202
GPT-4o mini Transcribe,interest,464,28,18,510,0.09019607843137256
whisper-small,our,6870,427,254,7551,0.09018673023440604
whisper-small,related,434,19,24,477,0.09014675052410903
whisper-large-v3-turbo,towards,101,9,1,111,0.09009009009009006
whisper-small,set,101,3,7,111,0.09009009009009006
whisper-small,through,374,18,19,411,0.09002433090024331
GPT-4o mini Transcribe,software,91,9,0,100,0.08999999999999997
whisper-small,going,445,24,20,489,0.08997955010224945
whisper-large-v3-turbo,out,415,19,22,456,0.08991228070175439
GPT-4o mini Transcribe,range,517,27,24,568,0.08978873239436624
whisper-small,term,365,25,11,401,0.08977556109725682
GPT-4o mini Transcribe,committed,71,6,1,78,0.08974358974358976
whisper-large-v3-turbo,continuing,71,6,1,78,0.08974358974358976
whisper-small,and,14667,929,516,16112,0.08968470705064546
GPT-4o mini Transcribe,pandemic,183,15,3,201,0.08955223880597019
whisper-small,have,2196,150,66,2412,0.08955223880597019
whisper-large-v3-turbo,sector,61,6,0,67,0.08955223880597019
GPT-4o mini Transcribe,perspective,61,0,6,67,0.08955223880597019
whisper-large-v3-turbo,general,122,12,0,134,0.08955223880597019
whisper-small,started,61,3,3,67,0.08955223880597019
whisper-small,sector,61,3,3,67,0.08955223880597019
GPT-4o mini Transcribe,started,61,3,3,67,0.08955223880597019
GPT-4o mini Transcribe,period,784,53,24,861,0.08943089430894313
whisper-large-v3-turbo,more,937,65,27,1029,0.0894071914480078
whisper-small,record,265,19,7,291,0.0893470790378007
whisper-large-v3-turbo,quality,51,4,1,56,0.0892857142857143
whisper-small,from,3745,216,151,4112,0.08925097276264593
whisper-small,on,5807,350,219,6376,0.08924090338770385
GPT-4o mini Transcribe,thats,756,51,23,830,0.08915662650602407
whisper-large-v3-turbo,ended,174,7,10,191,0.08900523560209428
whisper-large-v3-turbo,expect,830,53,28,911,0.0889132821075741
whisper-small,slightly,246,9,15,270,0.0888888888888889
GPT-4o mini Transcribe,increase,1984,105,88,2177,0.08865411116214972
whisper-large-v3-turbo,consecutive,72,4,3,79,0.08860759493670889
whisper-large-v3-turbo,million,9031,550,328,9909,0.08860631748915127
GPT-4o mini Transcribe,annual,494,20,28,542,0.08856088560885611
whisper-small,margin,2460,151,88,2699,0.0885513153019637
whisper-small,ended,175,11,6,192,0.08854166666666663
whisper-small,operational,103,4,6,113,0.08849557522123896
whisper-small,total,1217,62,56,1335,0.0883895131086142
GPT-4o mini Transcribe,prices,196,10,9,215,0.08837209302325577
whisper-large-v3-turbo,paid,196,12,7,215,0.08837209302325577
whisper-small,grew,815,30,49,894,0.0883668903803132
whisper-small,be,1766,102,69,1937,0.08828084667010838
GPT-4o mini Transcribe,each,93,9,0,102,0.08823529411764708
GPT-4o mini Transcribe,looking,310,23,7,340,0.08823529411764708
GPT-4o mini Transcribe,provision,62,3,3,68,0.08823529411764708
whisper-small,fy21,93,9,0,102,0.08823529411764708
GPT-4o mini Transcribe,youre,186,15,3,204,0.08823529411764708
whisper-small,guiding,62,0,6,68,0.08823529411764708
whisper-small,management,228,19,3,250,0.08799999999999997
whisper-small,in,16608,1095,507,18210,0.08797364085667214
whisper-large-v3-turbo,key,187,12,6,205,0.08780487804878045
whisper-small,access,52,5,0,57,0.08771929824561409
whisper-small,more,936,67,23,1026,0.08771929824561409
whisper-small,gains,156,8,7,171,0.08771929824561409
whisper-large-v3-turbo,now,1186,88,26,1300,0.08769230769230774
GPT-4o mini Transcribe,levels,281,21,6,308,0.08766233766233766
whisper-large-v3-turbo,of,20587,1196,779,22562,0.08753656590727776
whisper-small,statement,73,4,3,80,0.08750000000000002
whisper-large-v3-turbo,statement,73,4,3,80,0.08750000000000002
GPT-4o mini Transcribe,statement,73,7,0,80,0.08750000000000002
whisper-large-v3-turbo,core,261,19,6,286,0.0874125874125874
GPT-4o mini Transcribe,good,491,25,22,538,0.08736059479553904
whisper-large-v3-turbo,questions,209,16,4,229,0.0873362445414847
whisper-large-v3-turbo,cost,1819,79,95,1993,0.08730556949322632
whisper-small,months,1328,100,27,1455,0.08728522336769762
whisper-large-v3-turbo,average,619,31,28,678,0.08702064896755157
whisper-small,enterprise,63,6,0,69,0.08695652173913049
whisper-large-v3-turbo,account,126,3,9,138,0.08695652173913049
whisper-large-v3-turbo,luminex,63,3,3,69,0.08695652173913049
whisper-large-v3-turbo,cagr,63,6,0,69,0.08695652173913049
whisper-small,approximately,653,34,28,715,0.08671328671328671
whisper-large-v3-turbo,same,602,38,19,659,0.08649468892261003
whisper-large-v3-turbo,amount,169,9,7,185,0.08648648648648649
whisper-small,amount,169,13,3,185,0.08648648648648649
whisper-small,do,275,17,9,301,0.08637873754152825
whisper-large-v3-turbo,recovery,127,9,3,139,0.08633093525179858
whisper-small,so,2872,184,87,3143,0.08622335348393251
whisper-large-v3-turbo,additional,159,8,7,174,0.08620689655172409
GPT-4o mini Transcribe,close,308,13,16,337,0.08605341246290799
whisper-large-v3-turbo,pre,1541,90,55,1686,0.08600237247924081
whisper-large-v3-turbo,said,287,15,12,314,0.0859872611464968
whisper-large-v3-turbo,about,1491,95,45,1631,0.0858369098712446
whisper-large-v3-turbo,long,224,17,4,245,0.08571428571428574
whisper-small,therefore,128,9,3,140,0.08571428571428574
whisper-large-v3-turbo,goes,64,0,6,70,0.08571428571428574
whisper-small,goes,64,0,6,70,0.08571428571428574
GPT-4o mini Transcribe,goes,64,3,3,70,0.08571428571428574
whisper-small,profits,64,3,3,70,0.08571428571428574
whisper-small,consistent,64,6,0,70,0.08571428571428574
whisper-large-v3-turbo,interest,491,37,9,537,0.08566108007448792
whisper-large-v3-turbo,to,17004,1000,592,18596,0.08560980856098088
whisper-small,think,631,44,15,690,0.08550724637681162
GPT-4o mini Transcribe,related,428,11,29,468,0.0854700854700855
whisper-large-v3-turbo,what,685,41,23,749,0.0854472630173565
whisper-large-v3-turbo,financial,504,26,21,551,0.0852994555353902
whisper-large-v3-turbo,yes,118,8,3,129,0.0852713178294574
whisper-large-v3-turbo,you,3660,216,125,4001,0.08522869282679335
whisper-small,major,86,6,2,94,0.08510638297872342
GPT-4o mini Transcribe,fully,129,9,3,141,0.08510638297872342
whisper-large-v3-turbo,means,129,9,3,141,0.08510638297872342
whisper-small,account,129,3,9,141,0.08510638297872342
GPT-4o mini Transcribe,both,312,24,5,341,0.08504398826979476
whisper-large-v3-turbo,as,3274,194,110,3578,0.0849636668529905
whisper-large-v3-turbo,reflects,97,3,6,106,0.08490566037735847
whisper-small,incremental,97,3,6,106,0.08490566037735847
whisper-large-v3-turbo,q4,453,36,6,495,0.08484848484848484
GPT-4o mini Transcribe,third,1468,88,48,1604,0.08478802992518708
GPT-4o mini Transcribe,an,2076,92,100,2268,0.08465608465608465
whisper-small,contribution,292,12,15,319,0.08463949843260188
whisper-small,that,4798,285,158,5241,0.08452585384468614
whisper-large-v3-turbo,youre,195,15,3,213,0.08450704225352113
whisper-small,healthy,65,6,0,71,0.08450704225352113
whisper-small,youre,195,18,0,213,0.08450704225352113
whisper-large-v3-turbo,consumer,65,6,0,71,0.08450704225352113
GPT-4o mini Transcribe,tl,195,9,9,213,0.08450704225352113
whisper-small,basis,1127,38,66,1231,0.08448415922014618
whisper-small,across,206,12,7,225,0.08444444444444443
whisper-small,then,575,34,19,628,0.08439490445859876
whisper-large-v3-turbo,assets,217,14,6,237,0.08438818565400841
whisper-small,targets,76,0,7,83,0.08433734939759041
GPT-4o mini Transcribe,still,315,21,8,344,0.08430232558139539
whisper-large-v3-turbo,invested,98,6,3,107,0.08411214953271029
GPT-4o mini Transcribe,lower,588,21,33,642,0.08411214953271029
whisper-small,first,1764,113,49,1926,0.08411214953271029
whisper-large-v3-turbo,the,30122,1659,1107,32888,0.0841036244222817
whisper-large-v3-turbo,results,469,23,20,512,0.083984375
whisper-small,results,469,31,12,512,0.083984375
GPT-4o mini Transcribe,consolidated,240,12,10,262,0.08396946564885499
whisper-large-v3-turbo,primarily,251,7,16,274,0.08394160583941601
whisper-large-v3-turbo,for,7356,398,276,8030,0.08393524283935239
GPT-4o mini Transcribe,core,262,18,6,286,0.08391608391608396
whisper-small,plus,535,40,9,584,0.08390410958904104
whisper-small,your,623,32,25,680,0.08382352941176474
whisper-large-v3-turbo,may,164,9,6,179,0.08379888268156421
whisper-small,are,1894,96,77,2067,0.08369617803580065
whisper-large-v3-turbo,working,263,8,16,287,0.08362369337979092
whisper-small,about,1481,98,37,1616,0.08353960396039606
whisper-large-v3-turbo,significant,395,27,9,431,0.08352668213457082
whisper-large-v3-turbo,versus,922,63,21,1006,0.08349900596421467
GPT-4o mini Transcribe,net,3572,201,124,3897,0.0833974852450603
whisper-large-v3-turbo,a,9388,516,338,10242,0.08338215192345244
whisper-large-v3-turbo,showing,66,3,3,72,0.08333333333333337
GPT-4o mini Transcribe,aim,66,6,0,72,0.08333333333333337
GPT-4o mini Transcribe,charges,88,1,7,96,0.08333333333333337
GPT-4o mini Transcribe,common,66,3,3,72,0.08333333333333337
whisper-small,means,132,9,3,144,0.08333333333333337
whisper-large-v3-turbo,course,198,12,6,216,0.08333333333333337
whisper-small,continues,143,13,0,156,0.08333333333333337
whisper-large-v3-turbo,orders,121,0,11,132,0.08333333333333337
whisper-large-v3-turbo,last,1883,90,81,2054,0.08325219084712754
whisper-large-v3-turbo,excluding,353,21,11,385,0.08311688311688314
whisper-large-v3-turbo,even,254,9,14,277,0.0830324909747292
whisper-small,even,254,9,14,277,0.0830324909747292
whisper-small,rate,939,52,33,1024,0.0830078125
whisper-large-v3-turbo,euros,1085,59,39,1183,0.08284023668639051
whisper-small,i,2248,138,65,2451,0.08282333741330072
whisper-large-v3-turbo,made,111,9,1,121,0.0826446280991735
whisper-small,contracted,78,3,4,85,0.08235294117647063
whisper-large-v3-turbo,contracted,78,3,4,85,0.08235294117647063
whisper-small,than,1226,75,35,1336,0.08233532934131738
whisper-small,next,602,31,23,656,0.08231707317073167
GPT-4o mini Transcribe,capital,1472,70,62,1604,0.0822942643391521
GPT-4o mini Transcribe,release,67,0,6,73,0.0821917808219178
whisper-large-v3-turbo,release,67,3,3,73,0.0821917808219178
whisper-small,consumption,67,6,0,73,0.0821917808219178
whisper-small,tax,1039,56,37,1132,0.08215547703180215
whisper-small,look,380,21,13,414,0.08212560386473433
whisper-large-v3-turbo,through,380,24,10,414,0.08212560386473433
whisper-large-v3-turbo,some,436,26,13,475,0.08210526315789479
GPT-4o mini Transcribe,effective,179,12,4,195,0.08205128205128209
whisper-large-v3-turbo,expected,593,31,22,646,0.08204334365325072
GPT-4o mini Transcribe,generated,280,24,1,305,0.08196721311475408
whisper-small,payments,112,7,3,122,0.08196721311475408
GPT-4o mini Transcribe,value,280,18,7,305,0.08196721311475408
whisper-small,company,258,16,7,281,0.08185053380782914
GPT-4o mini Transcribe,average,606,25,29,660,0.08181818181818179
GPT-4o mini Transcribe,will,1371,68,54,1493,0.08171466845277964
whisper-small,nearly,169,9,6,184,0.08152173913043481
GPT-4o mini Transcribe,represented,124,3,8,135,0.08148148148148149
whisper-large-v3-turbo,shares,372,17,16,405,0.08148148148148149
whisper-large-v3-turbo,final,79,7,0,86,0.08139534883720934
whisper-small,up,1975,123,52,2150,0.08139534883720934
GPT-4o mini Transcribe,final,79,6,1,86,0.08139534883720934
GPT-4o mini Transcribe,without,79,1,6,86,0.08139534883720934
whisper-large-v3-turbo,selling,113,10,0,123,0.08130081300813008
GPT-4o mini Transcribe,industrial,113,9,1,123,0.08130081300813008
whisper-small,basically,113,10,0,123,0.08130081300813008
whisper-large-v3-turbo,where,260,7,16,283,0.08127208480565373
GPT-4o mini Transcribe,finally,147,9,4,160,0.08125000000000004
GPT-4o mini Transcribe,tax,1018,36,54,1108,0.08122743682310474
whisper-large-v3-turbo,page,249,13,9,271,0.08118081180811809
whisper-small,compare,68,3,3,74,0.08108108108108103
whisper-small,each,102,9,0,111,0.08108108108108103
whisper-large-v3-turbo,we,7925,443,256,8624,0.08105287569573283
whisper-large-v3-turbo,market,601,30,23,654,0.08103975535168195
whisper-small,month,227,13,7,247,0.08097165991902833
whisper-small,june,193,12,5,210,0.080952380952381
GPT-4o mini Transcribe,single,125,0,11,136,0.08088235294117652
whisper-small,has,875,40,37,952,0.08088235294117652
whisper-large-v3-turbo,from,3752,209,121,4082,0.08084272415482607
GPT-4o mini Transcribe,around,1137,52,48,1237,0.0808407437348424
GPT-4o mini Transcribe,asset,398,22,13,433,0.0808314087759815
whisper-small,place,57,5,0,62,0.08064516129032262
whisper-large-v3-turbo,morning,171,12,3,186,0.08064516129032262
whisper-large-v3-turbo,cash,2852,147,103,3102,0.08059316569954866
whisper-large-v3-turbo,annual,502,35,9,546,0.08058608058608063
whisper-large-v3-turbo,pay,80,6,1,87,0.08045977011494254
whisper-small,december,309,15,12,336,0.0803571428571429
whisper-large-v3-turbo,software,103,9,0,112,0.0803571428571429
GPT-4o mini Transcribe,made,103,9,0,112,0.0803571428571429
whisper-small,see,824,45,27,896,0.0803571428571429
GPT-4o mini Transcribe,q4,458,30,10,498,0.08032128514056225
whisper-small,today,229,10,10,249,0.08032128514056225
whisper-small,stock,298,12,14,324,0.08024691358024694
whisper-small,should,344,19,11,374,0.0802139037433155
whisper-large-v3-turbo,stood,172,6,9,187,0.0802139037433155
GPT-4o mini Transcribe,group,551,21,27,599,0.08013355592654425
whisper-large-v3-turbo,care,69,6,0,75,0.07999999999999996
whisper-small,charge,69,3,3,75,0.07999999999999996
GPT-4o mini Transcribe,build,69,3,3,75,0.07999999999999996
whisper-large-v3-turbo,year,8569,472,273,9314,0.07998711616920762
whisper-small,q2,311,20,7,338,0.07988165680473369
whisper-large-v3-turbo,within,173,6,9,188,0.07978723404255317
whisper-large-v3-turbo,operational,104,3,6,113,0.07964601769911506
whisper-small,show,104,6,3,113,0.07964601769911506
whisper-large-v3-turbo,and,14809,802,479,16090,0.07961466749533874
whisper-large-v3-turbo,going,451,13,26,490,0.07959183673469383
whisper-small,was,4557,231,163,4951,0.07957988285194906
GPT-4o mini Transcribe,economic,81,3,4,88,0.07954545454545459
whisper-large-v3-turbo,support,81,7,0,88,0.07954545454545459
whisper-large-v3-turbo,economic,81,3,4,88,0.07954545454545459
GPT-4o mini Transcribe,last,1841,103,56,2000,0.07950000000000002
whisper-small,but,1112,51,45,1208,0.07947019867549665
whisper-large-v3-turbo,quarter,6233,304,234,6771,0.07945650568601392
whisper-large-v3-turbo,impact,533,27,19,579,0.07944732297063906
whisper-large-v3-turbo,due,788,47,21,856,0.07943925233644855
whisper-small,non,384,27,6,417,0.07913669064748197
whisper-large-v3-turbo,were,1862,72,88,2022,0.0791295746785361
whisper-small,me,291,22,3,316,0.07911392405063289
GPT-4o mini Transcribe,us,1143,54,44,1241,0.07896857373086219
GPT-4o mini Transcribe,representing,315,12,15,342,0.07894736842105265
whisper-large-v3-turbo,maturity,70,3,3,76,0.07894736842105265
GPT-4o mini Transcribe,want,70,3,3,76,0.07894736842105265
whisper-large-v3-turbo,x,70,4,2,76,0.07894736842105265
GPT-4o mini Transcribe,x,70,1,5,76,0.07894736842105265
whisper-large-v3-turbo,representing,315,12,15,342,0.07894736842105265
GPT-4o mini Transcribe,gain,105,6,3,114,0.07894736842105265
whisper-large-v3-turbo,could,210,9,9,228,0.07894736842105265
whisper-large-v3-turbo,negative,292,13,12,317,0.07886435331230279
GPT-4o mini Transcribe,expansion,199,8,9,216,0.07870370370370372
GPT-4o mini Transcribe,cash,2828,111,130,3069,0.07852720755946563
GPT-4o mini Transcribe,very,963,49,33,1045,0.07846889952153113
whisper-small,something,141,0,12,153,0.07843137254901966
whisper-large-v3-turbo,all,987,45,39,1071,0.07843137254901966
whisper-small,over,2022,111,61,2194,0.07839562443026438
GPT-4o mini Transcribe,explained,106,3,6,115,0.07826086956521738
whisper-large-v3-turbo,its,1225,63,41,1329,0.07825432656132425
whisper-small,book,118,7,3,128,0.078125
GPT-4o mini Transcribe,better,236,10,10,256,0.078125
whisper-small,had,720,27,34,781,0.07810499359795131
whisper-large-v3-turbo,months,1358,84,31,1473,0.078071961982349
whisper-large-v3-turbo,looking,319,23,4,346,0.0780346820809249
whisper-small,available,71,1,5,77,0.07792207792207795
whisper-large-v3-turbo,order,142,12,0,154,0.07792207792207795
whisper-small,throughout,71,0,6,77,0.07792207792207795
GPT-4o mini Transcribe,excluding,355,15,15,385,0.07792207792207795
GPT-4o mini Transcribe,a,9323,340,447,10110,0.07784371909000987
whisper-large-v3-turbo,at,4196,212,142,4550,0.07780219780219777
whisper-small,all,985,54,29,1068,0.07771535580524347
whisper-small,sales,3098,163,98,3359,0.07770169693361118
GPT-4o mini Transcribe,than,1199,66,35,1300,0.07769230769230773
whisper-large-v3-turbo,change,107,6,3,116,0.07758620689655171
GPT-4o mini Transcribe,stable,131,2,9,142,0.07746478873239437
whisper-small,down,882,60,14,956,0.07740585774058573
whisper-large-v3-turbo,on,5865,335,157,6357,0.07739499764039637
whisper-small,maybe,167,10,4,181,0.07734806629834257
whisper-small,reflecting,167,10,4,181,0.07734806629834257
whisper-large-v3-turbo,see,835,57,13,905,0.07734806629834257
whisper-small,amounted,179,12,3,194,0.07731958762886593
whisper-large-v3-turbo,regarding,191,3,13,207,0.07729468599033817
whisper-large-v3-turbo,not,693,25,33,751,0.07723035952063917
whisper-small,profit,1016,69,16,1101,0.07720254314259767
whisper-large-v3-turbo,total,1232,66,37,1335,0.07715355805243451
GPT-4o mini Transcribe,guidance,1400,83,34,1517,0.07712590639419903
whisper-small,day,359,15,15,389,0.07712082262210795
GPT-4o mini Transcribe,pre,1534,66,62,1662,0.07701564380264736
whisper-small,given,252,15,6,273,0.07692307692307687
whisper-small,closed,84,6,1,91,0.07692307692307687
GPT-4o mini Transcribe,review,48,4,0,52,0.07692307692307687
whisper-large-v3-turbo,review,48,1,3,52,0.07692307692307687
whisper-small,złoty,72,6,0,78,0.07692307692307687
GPT-4o mini Transcribe,commodity,48,4,0,52,0.07692307692307687
whisper-small,planned,72,3,3,78,0.07692307692307687
whisper-small,gross,722,39,21,782,0.07672634271099743
GPT-4o mini Transcribe,almost,337,10,18,365,0.0767123287671233
whisper-large-v3-turbo,than,1228,61,41,1330,0.07669172932330826
whisper-large-v3-turbo,balance,301,16,9,326,0.07668711656441718
whisper-large-v3-turbo,me,289,21,3,313,0.07667731629392971
GPT-4o mini Transcribe,financial,506,25,17,548,0.07664233576642332
GPT-4o mini Transcribe,paid,193,12,4,209,0.07655502392344493
whisper-small,if,834,38,31,903,0.07641196013289031
whisper-small,offset,133,10,1,144,0.07638888888888884
GPT-4o mini Transcribe,market,618,31,20,669,0.07623318385650224
whisper-large-v3-turbo,tax,1043,44,42,1129,0.0761736049601417
whisper-small,there,522,23,20,565,0.07610619469026547
GPT-4o mini Transcribe,call,328,6,21,355,0.07605633802816902
GPT-4o mini Transcribe,management,231,15,4,250,0.07599999999999996
GPT-4o mini Transcribe,ebitda,1861,88,65,2014,0.07596822244289969
whisper-large-v3-turbo,liability,73,6,0,79,0.07594936708860756
GPT-4o mini Transcribe,effects,73,6,0,79,0.07594936708860756
whisper-large-v3-turbo,payout,146,9,3,158,0.07594936708860756
whisper-large-v3-turbo,real,73,3,3,79,0.07594936708860756
whisper-small,payout,146,12,0,158,0.07594936708860756
GPT-4o mini Transcribe,real,73,6,0,79,0.07594936708860756
GPT-4o mini Transcribe,of,20549,971,717,22237,0.07590952016908759
whisper-small,activities,183,9,6,198,0.0757575757575758
whisper-large-v3-turbo,in,16786,862,513,18161,0.07571168988491828
whisper-large-v3-turbo,think,635,24,28,687,0.07569141193595341
whisper-small,due,794,37,28,859,0.07566938300349246
GPT-4o mini Transcribe,low,269,13,9,291,0.07560137457044669
whisper-small,capacity,159,13,0,172,0.07558139534883723
GPT-4o mini Transcribe,then,575,24,23,622,0.07556270096463025
GPT-4o mini Transcribe,early,98,1,7,106,0.07547169811320753
whisper-small,growth,5121,257,161,5539,0.07546488535836793
whisper-large-v3-turbo,start,184,6,9,199,0.07537688442211055
GPT-4o mini Transcribe,added,86,4,3,93,0.07526881720430112
whisper-small,step,86,7,0,93,0.07526881720430112
whisper-large-v3-turbo,because,344,24,4,372,0.07526881720430112
whisper-small,added,86,4,3,93,0.07526881720430112
whisper-large-v3-turbo,added,86,3,4,93,0.07526881720430112
whisper-large-v3-turbo,which,2262,99,85,2446,0.07522485690923952
whisper-small,return,480,26,13,519,0.07514450867052025
whisper-small,digital,222,9,9,240,0.07499999999999996
whisper-small,strategy,111,9,0,120,0.07499999999999996
GPT-4o mini Transcribe,minus,185,9,6,200,0.07499999999999996
GPT-4o mini Transcribe,improved,321,8,18,347,0.0749279538904899
GPT-4o mini Transcribe,to,17016,779,598,18393,0.0748654379383461
whisper-small,early,99,3,5,107,0.07476635514018692
whisper-large-v3-turbo,early,99,0,8,107,0.07476635514018692
GPT-4o mini Transcribe,year,8511,395,292,9198,0.07469015003261581
GPT-4o mini Transcribe,million,8974,407,317,9698,0.07465456795215508
GPT-4o mini Transcribe,allocation,124,3,7,134,0.07462686567164178
whisper-large-v3-turbo,building,62,4,1,67,0.07462686567164178
whisper-large-v3-turbo,can,620,31,19,670,0.07462686567164178
whisper-large-v3-turbo,know,1030,60,23,1113,0.07457322551662171
whisper-large-v3-turbo,flow,1055,52,33,1140,0.07456140350877194
GPT-4o mini Transcribe,were,1863,70,80,2013,0.0745156482861401
GPT-4o mini Transcribe,corporate,87,0,7,94,0.07446808510638303
GPT-4o mini Transcribe,reflecting,162,6,7,175,0.07428571428571429
GPT-4o mini Transcribe,generation,162,12,1,175,0.07428571428571429
GPT-4o mini Transcribe,when,474,26,12,512,0.07421875
GPT-4o mini Transcribe,quarter,6248,284,216,6748,0.07409602845287488
whisper-large-v3-turbo,zloty,75,6,0,81,0.07407407407407407
whisper-small,did,125,9,1,135,0.07407407407407407
whisper-large-v3-turbo,represented,125,9,1,135,0.07407407407407407
whisper-small,benefits,50,4,0,54,0.07407407407407407
whisper-large-v3-turbo,danish,75,6,0,81,0.07407407407407407
whisper-small,danish,75,6,0,81,0.07407407407407407
whisper-large-v3-turbo,production,413,27,6,446,0.07399103139013452
whisper-large-v3-turbo,there,526,26,16,568,0.073943661971831
GPT-4o mini Transcribe,do,276,7,15,298,0.0738255033557047
whisper-large-v3-turbo,terms,640,30,21,691,0.0738060781476122
whisper-large-v3-turbo,but,1117,55,34,1206,0.07379767827529027
whisper-large-v3-turbo,least,113,3,6,122,0.07377049180327866
GPT-4o mini Transcribe,basically,113,9,0,122,0.07377049180327866
whisper-small,expectations,88,3,4,95,0.0736842105263158
whisper-large-v3-turbo,rd,189,15,0,204,0.07352941176470584
GPT-4o mini Transcribe,cost,1807,65,78,1950,0.07333333333333336
whisper-large-v3-turbo,so,2933,145,87,3165,0.07330173775671411
whisper-large-v3-turbo,has,885,41,29,955,0.0732984293193717
whisper-large-v3-turbo,then,582,33,13,628,0.07324840764331209
whisper-large-v3-turbo,is,6187,328,161,6676,0.07324745356500895
whisper-large-v3-turbo,have,2241,114,63,2418,0.07320099255583123
whisper-large-v3-turbo,basically,114,6,3,123,0.07317073170731703
whisper-large-v3-turbo,investment,228,11,7,246,0.07317073170731703
whisper-large-v3-turbo,leading,114,6,3,123,0.07317073170731703
GPT-4o mini Transcribe,strategy,114,6,3,123,0.07317073170731703
whisper-large-v3-turbo,rotation,76,0,6,82,0.07317073170731703
whisper-large-v3-turbo,industrial,114,6,3,123,0.07317073170731703
GPT-4o mini Transcribe,day,355,13,15,383,0.07310704960835512
GPT-4o mini Transcribe,all,951,42,33,1026,0.07309941520467833
GPT-4o mini Transcribe,quite,127,7,3,137,0.07299270072992703
GPT-4o mini Transcribe,expenses,1080,34,51,1165,0.07296137339055797
whisper-large-v3-turbo,result,548,30,13,591,0.07275803722504226
whisper-large-v3-turbo,excellent,51,3,1,55,0.07272727272727275
whisper-large-v3-turbo,bridge,51,1,3,55,0.07272727272727275
GPT-4o mini Transcribe,although,51,0,4,55,0.07272727272727275
GPT-4o mini Transcribe,excellent,51,0,4,55,0.07272727272727275
whisper-large-v3-turbo,performance,639,29,21,689,0.07256894049346885
GPT-4o mini Transcribe,plan,179,0,14,193,0.07253886010362698
GPT-4o mini Transcribe,about,1486,83,33,1602,0.07240948813982517
GPT-4o mini Transcribe,not,692,30,24,746,0.07238605898123329
whisper-small,operating,2012,91,66,2169,0.07238358690640845
GPT-4o mini Transcribe,more,949,56,18,1023,0.07233626588465303
GPT-4o mini Transcribe,through,372,21,8,401,0.07231920199501252
whisper-large-v3-turbo,strategic,77,6,0,83,0.07228915662650603
GPT-4o mini Transcribe,profit,1014,38,41,1093,0.07227813357731017
whisper-large-v3-turbo,are,1902,75,73,2050,0.07219512195121947
whisper-small,clear,90,3,4,97,0.07216494845360821
GPT-4o mini Transcribe,q3,669,19,33,721,0.07212205270457694
GPT-4o mini Transcribe,flow,1044,43,38,1125,0.07199999999999995
whisper-small,global,129,7,3,139,0.07194244604316546
whisper-small,also,1097,47,38,1182,0.071912013536379
GPT-4o mini Transcribe,negative,297,9,14,320,0.07187500000000002
whisper-large-v3-turbo,please,323,22,3,348,0.07183908045977017
whisper-large-v3-turbo,almost,349,4,23,376,0.07180851063829785
GPT-4o mini Transcribe,high,375,18,11,404,0.07178217821782173
whisper-large-v3-turbo,estimate,207,9,7,223,0.0717488789237668
GPT-4o mini Transcribe,gross,699,22,32,753,0.07171314741035861
GPT-4o mini Transcribe,with,4085,185,130,4400,0.07159090909090904
whisper-large-v3-turbo,that,4879,232,144,5255,0.07155090390104657
whisper-large-v3-turbo,impacted,130,9,1,140,0.0714285714285714
whisper-large-v3-turbo,expanded,78,6,0,84,0.0714285714285714
whisper-small,consolidation,78,6,0,84,0.0714285714285714
whisper-small,quality,52,1,3,56,0.0714285714285714
whisper-large-v3-turbo,consolidation,78,6,0,84,0.0714285714285714
GPT-4o mini Transcribe,okay,234,18,0,252,0.0714285714285714
whisper-large-v3-turbo,with,4116,195,121,4432,0.07129963898916969
GPT-4o mini Transcribe,and,14761,619,513,15893,0.07122632605549617
whisper-large-v3-turbo,end,861,19,47,927,0.07119741100323629
GPT-4o mini Transcribe,course,196,3,12,211,0.07109004739336489
GPT-4o mini Transcribe,like,510,18,21,549,0.07103825136612019
whisper-large-v3-turbo,fixed,131,7,3,141,0.07092198581560283
GPT-4o mini Transcribe,fixed,131,3,7,141,0.07092198581560283
whisper-large-v3-turbo,next,616,27,20,663,0.07088989441930615
whisper-large-v3-turbo,or,1561,59,60,1680,0.0708333333333333
whisper-large-v3-turbo,projects,105,8,0,113,0.07079646017699115
GPT-4o mini Transcribe,rmb,210,12,4,226,0.07079646017699115
whisper-small,projects,105,5,3,113,0.07079646017699115
GPT-4o mini Transcribe,purchase,105,7,1,113,0.07079646017699115
whisper-large-v3-turbo,unit,302,11,12,325,0.0707692307692308
GPT-4o mini Transcribe,make,92,6,1,99,0.07070707070707072
GPT-4o mini Transcribe,transactions,92,3,4,99,0.07070707070707072
GPT-4o mini Transcribe,q1,368,18,10,396,0.07070707070707072
whisper-large-v3-turbo,generate,92,6,1,99,0.07070707070707072
GPT-4o mini Transcribe,by,4446,198,140,4784,0.07065217391304346
GPT-4o mini Transcribe,contracted,79,6,0,85,0.07058823529411762
whisper-small,worth,79,0,6,85,0.07058823529411762
GPT-4o mini Transcribe,into,435,24,9,468,0.07051282051282048
whisper-large-v3-turbo,our,7018,351,181,7550,0.07046357615894039
whisper-small,partially,66,4,1,71,0.07042253521126762
GPT-4o mini Transcribe,adjusted,1360,27,76,1463,0.07040328092959669
GPT-4o mini Transcribe,second,899,38,30,967,0.07032057911065148
whisper-large-v3-turbo,marketing,119,9,0,128,0.0703125
GPT-4o mini Transcribe,stock,291,9,13,313,0.07028753993610226
whisper-large-v3-turbo,sales,3140,150,87,3377,0.07018063369854899
GPT-4o mini Transcribe,gains,159,7,5,171,0.07017543859649122
GPT-4o mini Transcribe,specific,53,4,0,57,0.07017543859649122
whisper-large-v3-turbo,track,53,0,4,57,0.07017543859649122
GPT-4o mini Transcribe,access,53,4,0,57,0.07017543859649122
GPT-4o mini Transcribe,performance,636,41,7,684,0.07017543859649122
whisper-large-v3-turbo,if,848,45,19,912,0.07017543859649122
whisper-large-v3-turbo,access,53,4,0,57,0.07017543859649122
whisper-small,years,849,44,20,913,0.07009857612267256
whisper-small,higher,930,39,31,1000,0.06999999999999995
whisper-small,include,93,3,4,100,0.06999999999999995
GPT-4o mini Transcribe,shows,133,6,4,143,0.0699300699300699
whisper-large-v3-turbo,was,4594,214,131,4939,0.06985219680097188
whisper-large-v3-turbo,profit,1013,55,21,1089,0.0697887970615243
whisper-large-v3-turbo,unchanged,80,3,3,86,0.06976744186046513
GPT-4o mini Transcribe,whole,80,6,0,86,0.06976744186046513
whisper-small,basic,80,6,0,86,0.06976744186046513
whisper-small,lets,307,13,10,330,0.0696969696969697
whisper-small,debt,988,46,28,1062,0.06967984934086624
whisper-large-v3-turbo,new,521,31,8,560,0.06964285714285712
whisper-small,say,294,16,6,316,0.069620253164557
GPT-4o mini Transcribe,underlying,254,6,13,273,0.06959706959706957
GPT-4o mini Transcribe,inflation,107,5,3,115,0.06956521739130439
GPT-4o mini Transcribe,approximately,656,17,32,705,0.06950354609929077
GPT-4o mini Transcribe,the,30287,1337,922,32546,0.06940945123824738
GPT-4o mini Transcribe,ahead,161,9,3,173,0.06936416184971095
GPT-4o mini Transcribe,large,94,6,1,101,0.06930693069306926
GPT-4o mini Transcribe,think,618,24,22,664,0.06927710843373491
whisper-large-v3-turbo,operating,2016,97,53,2166,0.06925207756232687
whisper-small,organic,713,36,17,766,0.06919060052219317
GPT-4o mini Transcribe,at,4198,180,132,4510,0.06917960088691799
whisper-large-v3-turbo,line,552,25,16,593,0.06913996627318719
whisper-small,business,943,42,28,1013,0.06910167818361301
whisper-large-v3-turbo,call,337,10,15,362,0.06906077348066297
whisper-small,into,445,16,17,478,0.06903765690376573
GPT-4o mini Transcribe,pl,54,0,4,58,0.06896551724137934
GPT-4o mini Transcribe,impacts,54,1,3,58,0.06896551724137934
whisper-small,yoy,81,6,0,87,0.06896551724137934
GPT-4o mini Transcribe,consolidation,81,6,0,87,0.06896551724137934
GPT-4o mini Transcribe,provisions,81,3,3,87,0.06896551724137934
whisper-large-v3-turbo,yoy,81,0,6,87,0.06896551724137934
whisper-large-v3-turbo,had,730,32,22,784,0.06887755102040816
whisper-small,segments,149,6,5,160,0.06874999999999998
GPT-4o mini Transcribe,record,271,16,4,291,0.06872852233676974
whisper-small,exchange,244,6,12,262,0.06870229007633588
whisper-large-v3-turbo,make,95,6,1,102,0.06862745098039214
GPT-4o mini Transcribe,me,285,18,3,306,0.06862745098039214
GPT-4o mini Transcribe,as,3271,142,99,3512,0.068621867881549
whisper-large-v3-turbo,capex,258,10,9,277,0.06859205776173283
GPT-4o mini Transcribe,nearly,163,3,9,175,0.06857142857142862
whisper-large-v3-turbo,by,4540,225,109,4874,0.06852687730816576
GPT-4o mini Transcribe,results,476,27,8,511,0.06849315068493156
GPT-4o mini Transcribe,it,1485,59,50,1594,0.06838143036386446
whisper-large-v3-turbo,during,818,19,41,878,0.06833712984054674
whisper-small,revenue,3041,106,117,3264,0.06832107843137258
GPT-4o mini Transcribe,same,614,33,12,659,0.06828528072837636
whisper-large-v3-turbo,top,246,15,3,264,0.06818181818181823
GPT-4o mini Transcribe,given,246,18,0,264,0.06818181818181823
whisper-large-v3-turbo,taxes,123,3,6,132,0.06818181818181823
GPT-4o mini Transcribe,full,671,33,16,720,0.06805555555555554
whisper-large-v3-turbo,i,2290,79,88,2457,0.06796906796906799
whisper-large-v3-turbo,focus,96,6,1,103,0.06796116504854366
whisper-large-v3-turbo,crores,288,6,15,309,0.06796116504854366
GPT-4o mini Transcribe,significant,398,21,8,427,0.0679156908665105
whisper-large-v3-turbo,stock,302,9,13,324,0.0679012345679012
GPT-4o mini Transcribe,what,688,30,20,738,0.0677506775067751
whisper-small,slide,936,43,25,1004,0.0677290836653387
whisper-large-v3-turbo,customer,124,3,6,133,0.06766917293233088
whisper-large-v3-turbo,acquisitions,138,6,4,148,0.06756756756756754
GPT-4o mini Transcribe,acquisitions,138,6,4,148,0.06756756756756754
whisper-small,acquisitions,138,6,4,148,0.06756756756756754
whisper-large-v3-turbo,single,138,6,4,148,0.06756756756756754
GPT-4o mini Transcribe,overall,387,15,13,415,0.06746987951807226
GPT-4o mini Transcribe,note,83,3,3,89,0.0674157303370787
GPT-4o mini Transcribe,has,886,37,27,950,0.06736842105263163
whisper-large-v3-turbo,costs,540,28,11,579,0.06735751295336789
whisper-large-v3-turbo,products,194,9,5,208,0.06730769230769229
GPT-4o mini Transcribe,crores,291,3,18,312,0.06730769230769229
GPT-4o mini Transcribe,was,4568,216,113,4897,0.06718399019808041
GPT-4o mini Transcribe,expect,847,30,31,908,0.06718061674008813
whisper-small,get,125,6,3,134,0.06716417910447758
GPT-4o mini Transcribe,mentioned,306,13,9,328,0.06707317073170727
whisper-small,may,167,9,3,179,0.06703910614525144
whisper-large-v3-turbo,volumes,167,11,1,179,0.06703910614525144
whisper-large-v3-turbo,be,1796,80,49,1925,0.06701298701298697
GPT-4o mini Transcribe,fees,181,9,4,194,0.0670103092783505
GPT-4o mini Transcribe,markets,209,12,3,224,0.0669642857142857
whisper-small,main,223,9,7,239,0.06694560669456062
whisper-large-v3-turbo,move,126,6,3,135,0.06666666666666665
whisper-large-v3-turbo,maintenance,84,6,0,90,0.06666666666666665
whisper-small,giving,84,0,6,90,0.06666666666666665
GPT-4o mini Transcribe,operation,126,9,0,135,0.06666666666666665
whisper-large-v3-turbo,common,70,4,1,75,0.06666666666666665
whisper-small,how,266,18,1,285,0.06666666666666665
whisper-large-v3-turbo,slightly,252,6,12,270,0.06666666666666665
whisper-large-v3-turbo,giving,84,3,3,90,0.06666666666666665
whisper-small,move,126,6,3,135,0.06666666666666665
whisper-large-v3-turbo,rupees,84,3,3,90,0.06666666666666665
whisper-large-v3-turbo,base,266,18,1,285,0.06666666666666665
whisper-small,small,56,0,4,60,0.06666666666666665
whisper-large-v3-turbo,how,266,18,1,285,0.06666666666666665
GPT-4o mini Transcribe,or,1569,57,55,1681,0.06662700773349195
GPT-4o mini Transcribe,been,632,26,19,677,0.06646971935007384
whisper-large-v3-turbo,your,632,27,18,677,0.06646971935007384
GPT-4o mini Transcribe,we,8036,336,236,8608,0.06644981412639406
GPT-4o mini Transcribe,so,2970,113,98,3181,0.06633134234517446
GPT-4o mini Transcribe,euros,1029,49,24,1102,0.06624319419237745
whisper-large-v3-turbo,comes,127,9,0,136,0.06617647058823528
whisper-small,mainly,438,6,25,469,0.06609808102345416
whisper-small,special,85,3,3,91,0.06593406593406592
whisper-small,demand,170,3,9,182,0.06593406593406592
GPT-4o mini Transcribe,contribution,298,15,6,319,0.0658307210031348
whisper-small,decline,284,6,14,304,0.06578947368421051
whisper-large-v3-turbo,current,284,10,10,304,0.06578947368421051
GPT-4o mini Transcribe,consecutive,71,2,3,76,0.06578947368421051
whisper-large-v3-turbo,well,781,32,23,836,0.06578947368421051
whisper-large-v3-turbo,group,554,30,9,593,0.06576728499156825
whisper-small,another,199,8,6,213,0.06572769953051638
GPT-4o mini Transcribe,against,128,3,6,137,0.06569343065693434
whisper-large-v3-turbo,against,128,6,3,137,0.06569343065693434
whisper-small,question,370,16,10,396,0.06565656565656564
whisper-small,impact,541,26,12,579,0.0656303972366149
GPT-4o mini Transcribe,right,299,9,12,320,0.06562500000000004
whisper-large-v3-turbo,fourth,655,28,18,701,0.06562054208273893
GPT-4o mini Transcribe,place,57,4,0,61,0.06557377049180324
whisper-small,although,57,3,1,61,0.06557377049180324
GPT-4o mini Transcribe,inventory,57,0,4,61,0.06557377049180324
whisper-large-v3-turbo,payments,114,5,3,122,0.06557377049180324
whisper-large-v3-turbo,inventory,57,0,4,61,0.06557377049180324
GPT-4o mini Transcribe,lastly,57,0,4,61,0.06557377049180324
whisper-small,commercial,157,4,7,168,0.06547619047619047
GPT-4o mini Transcribe,up,2000,82,58,2140,0.06542056074766356
GPT-4o mini Transcribe,which,2287,93,67,2447,0.06538618716796074
whisper-large-v3-turbo,decrease,329,17,6,352,0.06534090909090906
GPT-4o mini Transcribe,reached,358,16,9,383,0.06527415143603132
whisper-small,backlog,86,3,3,92,0.06521739130434778
GPT-4o mini Transcribe,mostly,86,3,3,92,0.06521739130434778
GPT-4o mini Transcribe,colombia,86,3,3,92,0.06521739130434778
whisper-large-v3-turbo,nearly,172,6,6,184,0.06521739130434778
whisper-small,improved,330,13,10,353,0.06515580736543913
GPT-4o mini Transcribe,take,244,6,11,261,0.06513409961685823
whisper-small,date,201,6,8,215,0.06511627906976747
GPT-4o mini Transcribe,only,316,12,10,338,0.0650887573964497
whisper-large-v3-turbo,gain,115,8,0,123,0.06504065040650409
GPT-4o mini Transcribe,unit,302,18,3,323,0.06501547987616096
whisper-small,units,144,6,4,154,0.06493506493506496
GPT-4o mini Transcribe,for,7417,294,221,7932,0.0649268784669692
GPT-4o mini Transcribe,now,1196,53,30,1279,0.06489444878811568
GPT-4o mini Transcribe,from,3792,164,99,4055,0.06485819975339091
whisper-small,provided,101,7,0,108,0.06481481481481477
whisper-large-v3-turbo,actually,260,9,9,278,0.06474820143884896
GPT-4o mini Transcribe,because,347,18,6,371,0.06469002695417791
GPT-4o mini Transcribe,days,116,6,2,124,0.06451612903225812
GPT-4o mini Transcribe,money,87,3,3,93,0.06451612903225812
GPT-4o mini Transcribe,thank,435,6,24,465,0.06451612903225812
whisper-large-v3-turbo,place,58,1,3,62,0.06451612903225812
whisper-large-v3-turbo,summary,58,3,1,62,0.06451612903225812
whisper-large-v3-turbo,higher,930,48,16,994,0.06438631790744465
whisper-large-v3-turbo,margin,2531,102,72,2705,0.06432532347504616
GPT-4o mini Transcribe,came,277,7,12,296,0.06418918918918914
whisper-large-v3-turbo,first,1810,54,70,1934,0.06411582213029987
GPT-4o mini Transcribe,margin,2497,82,89,2668,0.0640929535232384
whisper-small,days,117,6,2,125,0.06399999999999995
GPT-4o mini Transcribe,be,1847,68,58,1973,0.06386213887480996
whisper-small,flat,88,3,3,94,0.06382978723404253
GPT-4o mini Transcribe,flat,88,3,3,94,0.06382978723404253
whisper-small,fully,132,6,3,141,0.06382978723404253
whisper-small,within,176,9,3,188,0.06382978723404253
whisper-small,barrel,220,6,9,235,0.06382978723404253
GPT-4o mini Transcribe,amounted,176,0,12,188,0.06382978723404253
whisper-large-v3-turbo,flat,88,3,3,94,0.06382978723404253
GPT-4o mini Transcribe,improving,88,0,6,94,0.06382978723404253
whisper-large-v3-turbo,fully,132,9,0,141,0.06382978723404253
GPT-4o mini Transcribe,that,4849,224,106,5179,0.06371886464568455
GPT-4o mini Transcribe,also,1088,39,35,1162,0.0636833046471601
whisper-large-v3-turbo,level,515,33,2,550,0.0636363636363636
whisper-small,opportunity,59,3,1,63,0.06349206349206349
whisper-small,morning,177,3,9,189,0.06349206349206349
whisper-small,february,59,0,4,63,0.06349206349206349
whisper-large-v3-turbo,number,487,19,14,520,0.06346153846153846
GPT-4o mini Transcribe,on,5862,247,150,6259,0.06342866272567504
whisper-large-v3-turbo,above,443,22,8,473,0.06342494714587743
whisper-large-v3-turbo,coming,207,4,10,221,0.06334841628959276
GPT-4o mini Transcribe,total,1229,44,39,1312,0.06326219512195119
GPT-4o mini Transcribe,shares,385,16,10,411,0.06326034063260344
GPT-4o mini Transcribe,terms,622,18,24,664,0.06325301204819278
GPT-4o mini Transcribe,sales,3140,124,88,3352,0.06324582338902152
whisper-large-v3-turbo,health,89,6,0,95,0.06315789473684208
GPT-4o mini Transcribe,base,267,11,7,285,0.06315789473684208
whisper-large-v3-turbo,days,119,6,2,127,0.06299212598425197
GPT-4o mini Transcribe,our,7011,283,188,7482,0.06295108259823579
GPT-4o mini Transcribe,welcome,134,3,6,143,0.06293706293706292
whisper-large-v3-turbo,into,447,16,14,477,0.06289308176100628
GPT-4o mini Transcribe,this,3875,123,137,4135,0.06287787182587667
whisper-small,driven,686,25,21,732,0.06284153005464477
whisper-small,risk,194,0,13,207,0.0628019323671497
whisper-large-v3-turbo,times,403,8,19,430,0.06279069767441858
whisper-small,some,448,20,10,478,0.06276150627615062
GPT-4o mini Transcribe,decline,284,4,15,303,0.06270627062706269
whisper-large-v3-turbo,again,359,21,3,383,0.06266318537859006
whisper-large-v3-turbo,basis,1154,42,35,1231,0.06255077173030055
whisper-large-v3-turbo,things,90,3,3,96,0.0625
whisper-large-v3-turbo,offset,135,9,0,144,0.0625
whisper-large-v3-turbo,roughly,240,10,6,256,0.0625
whisper-small,back,420,19,9,448,0.0625
whisper-large-v3-turbo,delivering,90,3,3,96,0.0625
whisper-large-v3-turbo,charges,90,2,4,96,0.0625
whisper-large-v3-turbo,achieve,90,0,6,96,0.0625
whisper-small,delivering,90,3,3,96,0.0625
whisper-large-v3-turbo,accounted,90,3,3,96,0.0625
whisper-small,decrease,330,21,1,352,0.0625
whisper-large-v3-turbo,exchange,240,7,9,256,0.0625
GPT-4o mini Transcribe,central,90,0,6,96,0.0625
GPT-4o mini Transcribe,means,135,6,3,144,0.0625
GPT-4o mini Transcribe,private,90,6,0,96,0.0625
GPT-4o mini Transcribe,past,150,7,3,160,0.0625
GPT-4o mini Transcribe,things,90,3,3,96,0.0625
whisper-large-v3-turbo,look,391,23,3,417,0.062350119904076684
whisper-small,ratio,722,26,22,770,0.06233766233766236
GPT-4o mini Transcribe,quarterly,286,6,13,305,0.06229508196721312
GPT-4o mini Transcribe,turning,166,1,10,177,0.062146892655367214
GPT-4o mini Transcribe,therefore,136,3,6,145,0.06206896551724139
GPT-4o mini Transcribe,prior,544,14,22,580,0.06206896551724139
GPT-4o mini Transcribe,below,272,15,3,290,0.06206896551724139
whisper-large-v3-turbo,up,2011,86,47,2144,0.06203358208955223
whisper-small,just,923,36,25,984,0.061991869918699205
GPT-4o mini Transcribe,pricing,91,6,0,97,0.061855670103092786
GPT-4o mini Transcribe,benefit,91,3,3,97,0.061855670103092786
GPT-4o mini Transcribe,estimated,76,0,5,81,0.06172839506172845
GPT-4o mini Transcribe,why,137,0,9,146,0.06164383561643838
whisper-large-v3-turbo,july,61,3,1,65,0.06153846153846154
whisper-small,take,244,6,10,260,0.06153846153846154
whisper-small,services,244,12,4,260,0.06153846153846154
whisper-small,july,61,3,1,65,0.06153846153846154
whisper-small,relative,61,4,0,65,0.06153846153846154
GPT-4o mini Transcribe,is,6210,254,153,6617,0.061508236360888646
GPT-4o mini Transcribe,set,107,0,7,114,0.06140350877192979
whisper-large-v3-turbo,improvement,306,13,7,326,0.06134969325153372
whisper-large-v3-turbo,digit,199,9,4,212,0.061320754716981174
whisper-large-v3-turbo,active,92,3,3,98,0.061224489795918324
whisper-large-v3-turbo,between,553,23,13,589,0.06112054329371819
whisper-large-v3-turbo,points,1122,39,34,1195,0.06108786610878658
GPT-4o mini Transcribe,questions,200,9,4,213,0.06103286384976525
whisper-large-v3-turbo,another,200,7,6,213,0.06103286384976525
whisper-small,estimated,77,0,5,82,0.060975609756097615
GPT-4o mini Transcribe,production,416,15,12,443,0.060948081264108334
GPT-4o mini Transcribe,sheet,185,9,3,197,0.060913705583756306
GPT-4o mini Transcribe,ebit,293,3,16,312,0.0608974358974359
whisper-small,short,108,3,4,115,0.060869565217391286
whisper-large-v3-turbo,maybe,170,10,1,181,0.06077348066298338
whisper-large-v3-turbo,this,3881,144,107,4132,0.06074540174249754
whisper-large-v3-turbo,month,232,12,3,247,0.06072874493927127
GPT-4o mini Transcribe,even,263,9,8,280,0.06071428571428572
GPT-4o mini Transcribe,in,16841,616,471,17928,0.06063141454707721
whisper-small,things,93,3,3,99,0.06060606060606055
whisper-small,kroner,93,6,0,99,0.06060606060606055
whisper-small,q4,465,30,0,495,0.06060606060606055
whisper-large-v3-turbo,kroner,93,6,0,99,0.06060606060606055
whisper-small,loan,155,6,4,165,0.06060606060606055
GPT-4o mini Transcribe,expected,605,17,22,644,0.060559006211180155
whisper-large-v3-turbo,continue,388,16,9,413,0.060532687651331685
GPT-4o mini Transcribe,thanks,202,6,7,215,0.06046511627906981
whisper-large-v3-turbo,business,948,33,28,1009,0.06045589692765119
GPT-4o mini Transcribe,continue,389,13,12,414,0.06038647342995174
whisper-large-v3-turbo,transaction,109,4,3,116,0.06034482758620685
whisper-small,transaction,109,6,1,116,0.06034482758620685
whisper-small,together,78,4,1,83,0.06024096385542166
GPT-4o mini Transcribe,capacity,156,7,3,166,0.06024096385542166
GPT-4o mini Transcribe,versus,937,30,30,997,0.06018054162487463
whisper-small,posted,250,10,6,266,0.06015037593984962
whisper-large-v3-turbo,approximately,672,24,19,715,0.06013986013986017
whisper-small,im,172,11,0,183,0.060109289617486295
GPT-4o mini Transcribe,give,188,12,0,200,0.06000000000000005
GPT-4o mini Transcribe,include,94,3,3,100,0.06000000000000005
whisper-large-v3-turbo,pricing,94,6,0,100,0.06000000000000005
whisper-small,benefit,94,3,3,100,0.06000000000000005
whisper-small,quick,94,6,0,100,0.06000000000000005
whisper-large-v3-turbo,include,94,0,6,100,0.06000000000000005
GPT-4o mini Transcribe,how,251,12,4,267,0.05992509363295884
whisper-large-v3-turbo,already,251,9,7,267,0.05992509363295884
GPT-4o mini Transcribe,driven,660,25,17,702,0.05982905982905984
whisper-large-v3-turbo,direct,63,0,4,67,0.05970149253731338
GPT-4o mini Transcribe,building,63,0,4,67,0.05970149253731338
whisper-small,direct,63,3,1,67,0.05970149253731338
whisper-small,talk,63,1,3,67,0.05970149253731338
GPT-4o mini Transcribe,where,268,7,10,285,0.05964912280701751
whisper-large-v3-turbo,strong,1057,42,25,1124,0.059608540925266906
GPT-4o mini Transcribe,actually,253,6,10,269,0.059479553903345694
GPT-4o mini Transcribe,however,190,9,3,202,0.05940594059405946
whisper-large-v3-turbo,large,95,6,0,101,0.05940594059405946
GPT-4o mini Transcribe,key,190,12,0,202,0.05940594059405946
whisper-small,expense,206,8,5,219,0.05936073059360736
GPT-4o mini Transcribe,months,1349,56,29,1434,0.05927475592747555
GPT-4o mini Transcribe,next,619,15,24,658,0.059270516717325195
whisper-small,however,191,12,0,203,0.059113300492610876
whisper-large-v3-turbo,gross,733,25,21,779,0.05905006418485237
whisper-small,page,255,11,5,271,0.059040590405904037
GPT-4o mini Transcribe,impact,527,19,14,560,0.05892857142857144
GPT-4o mini Transcribe,factor,48,0,3,51,0.05882352941176472
GPT-4o mini Transcribe,rd,192,12,0,204,0.05882352941176472
whisper-large-v3-turbo,wet,48,3,0,51,0.05882352941176472
whisper-large-v3-turbo,natural,48,0,3,51,0.05882352941176472
GPT-4o mini Transcribe,natural,48,0,3,51,0.05882352941176472
GPT-4o mini Transcribe,network,48,0,3,51,0.05882352941176472
GPT-4o mini Transcribe,food,48,3,0,51,0.05882352941176472
whisper-large-v3-turbo,accordingly,48,3,0,51,0.05882352941176472
GPT-4o mini Transcribe,bookings,48,3,0,51,0.05882352941176472
whisper-small,different,96,0,6,102,0.05882352941176472
whisper-large-v3-turbo,grown,48,3,0,51,0.05882352941176472
whisper-large-v3-turbo,raised,64,0,4,68,0.05882352941176472
GPT-4o mini Transcribe,cumulative,48,0,3,51,0.05882352941176472
whisper-large-v3-turbo,food,48,3,0,51,0.05882352941176472
GPT-4o mini Transcribe,something,144,0,9,153,0.05882352941176472
whisper-small,upper,48,3,0,51,0.05882352941176472
whisper-small,food,48,3,0,51,0.05882352941176472
GPT-4o mini Transcribe,showed,48,0,3,51,0.05882352941176472
whisper-small,natural,48,0,3,51,0.05882352941176472
GPT-4o mini Transcribe,raised,64,0,4,68,0.05882352941176472
whisper-small,wet,48,0,3,51,0.05882352941176472
GPT-4o mini Transcribe,might,48,3,0,51,0.05882352941176472
GPT-4o mini Transcribe,reported,321,10,10,341,0.058651026392961825
whisper-large-v3-turbo,free,626,17,22,665,0.05864661654135339
whisper-small,points,1125,49,21,1195,0.05857740585774063
GPT-4o mini Transcribe,operating,2027,85,41,2153,0.05852299117510451
whisper-small,program,177,8,3,188,0.058510638297872286
GPT-4o mini Transcribe,first,1772,57,53,1882,0.05844845908607865
whisper-large-v3-turbo,record,274,16,1,291,0.05841924398625431
GPT-4o mini Transcribe,company,274,10,7,291,0.05841924398625431
GPT-4o mini Transcribe,capex,258,7,9,274,0.058394160583941646
whisper-small,leading,113,7,0,120,0.05833333333333335
whisper-small,highest,97,3,3,103,0.058252427184465994
whisper-large-v3-turbo,plus,550,23,11,584,0.05821917808219179
GPT-4o mini Transcribe,you,3721,122,108,3951,0.05821311060491019
whisper-small,coming,211,6,7,224,0.0580357142857143
GPT-4o mini Transcribe,costs,536,23,10,569,0.05799648506151145
GPT-4o mini Transcribe,lot,65,1,3,69,0.05797101449275366
whisper-large-v3-turbo,since,260,15,1,276,0.05797101449275366
whisper-small,lot,65,1,3,69,0.05797101449275366
whisper-small,ebit,293,11,7,311,0.05787781350482313
GPT-4o mini Transcribe,these,586,26,10,622,0.05787781350482313
GPT-4o mini Transcribe,payments,114,1,6,121,0.05785123966942152
GPT-4o mini Transcribe,revenue,3046,106,81,3233,0.05784101453758117
whisper-large-v3-turbo,across,212,4,9,225,0.05777777777777782
GPT-4o mini Transcribe,order,147,9,0,156,0.05769230769230771
whisper-small,left,49,0,3,52,0.05769230769230771
whisper-small,dividends,147,9,0,156,0.05769230769230771
whisper-small,growing,245,9,6,260,0.05769230769230771
whisper-small,increases,147,7,2,156,0.05769230769230771
GPT-4o mini Transcribe,fx,49,0,3,52,0.05769230769230771
whisper-large-v3-turbo,left,49,0,3,52,0.05769230769230771
whisper-large-v3-turbo,brands,49,3,0,52,0.05769230769230771
GPT-4o mini Transcribe,left,49,0,3,52,0.05769230769230771
whisper-large-v3-turbo,lead,49,3,0,52,0.05769230769230771
GPT-4o mini Transcribe,despite,213,7,6,226,0.05752212389380529
GPT-4o mini Transcribe,slightly,246,3,12,261,0.05747126436781613
whisper-small,beyond,115,6,1,122,0.05737704918032782
whisper-small,pesos,362,13,9,384,0.05729166666666663
whisper-small,came,280,11,6,297,0.0572390572390572
GPT-4o mini Transcribe,regarding,198,6,6,210,0.05714285714285716
whisper-small,many,66,3,1,70,0.05714285714285716
whisper-small,guess,66,1,3,70,0.05714285714285716
GPT-4o mini Transcribe,many,66,3,1,70,0.05714285714285716
whisper-small,barrels,165,7,3,175,0.05714285714285716
whisper-large-v3-turbo,pounds,99,3,3,105,0.05714285714285716
whisper-small,pounds,99,3,3,105,0.05714285714285716
whisper-large-v3-turbo,increasing,248,9,6,263,0.057034220532319435
GPT-4o mini Transcribe,posted,248,6,9,263,0.057034220532319435
whisper-small,figures,149,6,3,158,0.05696202531645567
whisper-large-v3-turbo,payment,149,6,3,158,0.05696202531645567
whisper-small,products,199,9,3,211,0.056872037914691975
GPT-4o mini Transcribe,products,199,6,6,211,0.056872037914691975
whisper-small,such,83,3,2,88,0.05681818181818177
GPT-4o mini Transcribe,fourth,664,21,19,704,0.05681818181818177
whisper-large-v3-turbo,such,83,3,2,88,0.05681818181818177
whisper-large-v3-turbo,despite,216,6,7,229,0.05676855895196509
whisper-large-v3-turbo,outlook,216,4,9,229,0.05676855895196509
whisper-small,fixed,133,4,4,141,0.05673758865248224
GPT-4o mini Transcribe,term,366,16,6,388,0.05670103092783507
whisper-large-v3-turbo,increased,1564,69,25,1658,0.05669481302774426
GPT-4o mini Transcribe,level,516,27,4,547,0.05667276051188297
GPT-4o mini Transcribe,week,50,3,0,53,0.05660377358490565
whisper-large-v3-turbo,week,50,3,0,53,0.05660377358490565
whisper-small,future,100,0,6,106,0.05660377358490565
whisper-small,actual,50,0,3,53,0.05660377358490565
GPT-4o mini Transcribe,ma,50,0,3,53,0.05660377358490565
whisper-large-v3-turbo,would,717,26,17,760,0.05657894736842106
GPT-4o mini Transcribe,had,735,28,16,779,0.056482670089858744
GPT-4o mini Transcribe,those,284,6,11,301,0.056478405315614655
whisper-large-v3-turbo,contribution,301,15,3,319,0.056426332288401215
whisper-large-v3-turbo,posted,251,9,6,266,0.05639097744360899
whisper-small,partners,67,3,1,71,0.05633802816901412
whisper-large-v3-turbo,being,218,10,3,231,0.05627705627705626
GPT-4o mini Transcribe,today,235,6,8,249,0.05622489959839361
whisper-large-v3-turbo,back,420,13,12,445,0.0561797752808989
whisper-large-v3-turbo,term,370,21,1,392,0.056122448979591844
GPT-4o mini Transcribe,invested,101,3,3,107,0.05607476635514019
whisper-large-v3-turbo,rate,961,40,17,1018,0.055992141453831024
whisper-large-v3-turbo,down,894,36,17,947,0.05596620908130945
whisper-small,grow,254,9,6,269,0.055762081784386575
whisper-small,improvement,305,5,13,323,0.05572755417956654
GPT-4o mini Transcribe,time,458,19,8,485,0.05567010309278353
whisper-large-v3-turbo,aircraft,51,3,0,54,0.05555555555555558
whisper-small,proceeds,68,0,4,72,0.05555555555555558
whisper-small,network,51,0,3,54,0.05555555555555558
whisper-large-v3-turbo,bookings,51,3,0,54,0.05555555555555558
GPT-4o mini Transcribe,aircraft,51,3,0,54,0.05555555555555558
whisper-small,factor,51,0,3,54,0.05555555555555558
whisper-large-v3-turbo,roce,51,0,3,54,0.05555555555555558
whisper-small,scope,51,3,0,54,0.05555555555555558
whisper-large-v3-turbo,raise,51,3,0,54,0.05555555555555558
whisper-small,solid,204,4,8,216,0.05555555555555558
GPT-4o mini Transcribe,please,323,7,12,342,0.05555555555555558
whisper-small,fx,51,0,3,54,0.05555555555555558
GPT-4o mini Transcribe,trends,51,3,0,54,0.05555555555555558
whisper-small,though,51,0,3,54,0.05555555555555558
whisper-large-v3-turbo,showed,51,0,3,54,0.05555555555555558
whisper-small,raise,51,3,0,54,0.05555555555555558
whisper-small,best,85,4,1,90,0.05555555555555558
whisper-small,aircraft,51,3,0,54,0.05555555555555558
GPT-4o mini Transcribe,reason,51,3,0,54,0.05555555555555558
whisper-large-v3-turbo,network,51,0,3,54,0.05555555555555558
whisper-large-v3-turbo,reasons,68,0,4,72,0.05555555555555558
GPT-4o mini Transcribe,pounds,102,3,3,108,0.05555555555555558
GPT-4o mini Transcribe,raise,51,3,0,54,0.05555555555555558
whisper-large-v3-turbo,growth,5229,211,96,5536,0.05545520231213874
GPT-4o mini Transcribe,coming,222,4,9,235,0.05531914893617018
GPT-4o mini Transcribe,rates,205,5,7,217,0.055299539170506895
GPT-4o mini Transcribe,energy,188,9,2,199,0.055276381909547756
GPT-4o mini Transcribe,due,771,29,16,816,0.05514705882352944
whisper-large-v3-turbo,work,103,6,0,109,0.05504587155963303
GPT-4o mini Transcribe,work,103,6,0,109,0.05504587155963303
whisper-large-v3-turbo,grew,842,30,19,891,0.05499438832772163
whisper-large-v3-turbo,also,1117,27,38,1182,0.05499153976311333
whisper-large-v3-turbo,non,396,14,9,419,0.054892601431980936
GPT-4o mini Transcribe,during,793,17,29,839,0.0548271752085816
whisper-small,report,69,3,1,73,0.0547945205479452
GPT-4o mini Transcribe,reduced,138,3,5,146,0.0547945205479452
whisper-large-v3-turbo,sale,69,1,3,73,0.0547945205479452
whisper-large-v3-turbo,continued,311,14,4,329,0.054711246200607855
GPT-4o mini Transcribe,december,311,9,9,329,0.054711246200607855
GPT-4o mini Transcribe,strong,1054,42,19,1115,0.05470852017937222
GPT-4o mini Transcribe,have,2281,76,56,2413,0.05470368835474515
whisper-small,indicator,52,3,0,55,0.054545454545454564
whisper-small,front,52,3,0,55,0.054545454545454564
GPT-4o mini Transcribe,commerce,52,0,3,55,0.054545454545454564
whisper-large-v3-turbo,fx,52,0,3,55,0.054545454545454564
whisper-small,lost,52,0,3,55,0.054545454545454564
whisper-large-v3-turbo,commerce,52,3,0,55,0.054545454545454564
GPT-4o mini Transcribe,conditions,52,2,1,55,0.054545454545454564
whisper-large-v3-turbo,might,52,3,0,55,0.054545454545454564
whisper-large-v3-turbo,moving,330,13,6,349,0.054441260744985676
whisper-small,shares,383,18,4,405,0.05432098765432103
GPT-4o mini Transcribe,sustainable,70,0,4,74,0.05405405405405406
whisper-small,depreciation,105,3,3,111,0.05405405405405406
whisper-large-v3-turbo,each,105,6,0,111,0.05405405405405406
whisper-large-v3-turbo,depreciation,105,3,3,111,0.05405405405405406
whisper-small,line,561,13,19,593,0.053962900505902245
GPT-4o mini Transcribe,equity,579,26,7,612,0.05392156862745101
whisper-small,currency,158,6,3,167,0.053892215568862256
whisper-small,charges,88,1,4,93,0.053763440860215006
whisper-small,view,53,3,0,56,0.0535714285714286
whisper-large-v3-turbo,ask,53,0,3,56,0.0535714285714286
whisper-large-v3-turbo,todays,53,0,3,56,0.0535714285714286
GPT-4o mini Transcribe,kind,106,3,3,112,0.0535714285714286
whisper-small,targeting,53,0,3,56,0.0535714285714286
whisper-small,ask,53,3,0,56,0.0535714285714286
whisper-large-v3-turbo,plan,177,7,3,187,0.053475935828877
whisper-small,prior,549,21,10,580,0.05344827586206902
whisper-large-v3-turbo,prior,549,19,12,580,0.05344827586206902
whisper-small,could,213,3,9,225,0.053333333333333344
whisper-small,costs,551,17,14,582,0.053264604810996596
GPT-4o mini Transcribe,major,89,3,2,94,0.05319148936170215
whisper-large-v3-turbo,major,89,3,2,94,0.05319148936170215
whisper-small,kind,107,3,3,113,0.053097345132743334
whisper-large-v3-turbo,expansion,214,12,0,226,0.053097345132743334
whisper-small,service,232,6,7,245,0.05306122448979589
whisper-large-v3-turbo,thanks,197,9,2,208,0.05288461538461542
GPT-4o mini Transcribe,launched,54,3,0,57,0.052631578947368474
GPT-4o mini Transcribe,january,72,0,4,76,0.052631578947368474
whisper-small,closer,54,0,3,57,0.052631578947368474
whisper-small,between,558,12,19,589,0.052631578947368474
whisper-large-v3-turbo,gdp,54,0,3,57,0.052631578947368474
whisper-small,participants,72,0,4,76,0.052631578947368474
whisper-large-v3-turbo,sort,144,0,8,152,0.052631578947368474
whisper-small,gdp,54,0,3,57,0.052631578947368474
GPT-4o mini Transcribe,gdp,54,0,3,57,0.052631578947368474
whisper-large-v3-turbo,normalized,54,3,0,57,0.052631578947368474
whisper-large-v3-turbo,need,90,4,1,95,0.052631578947368474
whisper-large-v3-turbo,category,108,6,0,114,0.052631578947368474
whisper-large-v3-turbo,ebt,54,3,0,57,0.052631578947368474
whisper-large-v3-turbo,closer,54,0,3,57,0.052631578947368474
whisper-small,normalized,54,3,0,57,0.052631578947368474
GPT-4o mini Transcribe,losses,54,0,3,57,0.052631578947368474
GPT-4o mini Transcribe,closer,54,0,3,57,0.052631578947368474
GPT-4o mini Transcribe,normalized,54,3,0,57,0.052631578947368474
whisper-small,doing,54,3,0,57,0.052631578947368474
whisper-small,current,288,6,10,304,0.052631578947368474
GPT-4o mini Transcribe,upstream,54,3,0,57,0.052631578947368474
whisper-large-v3-turbo,upstream,54,3,0,57,0.052631578947368474
whisper-small,during,832,15,31,878,0.05239179954441908
whisper-large-v3-turbo,off,181,0,10,191,0.05235602094240843
GPT-4o mini Transcribe,higher,906,24,26,956,0.05230125523012552
GPT-4o mini Transcribe,got,109,6,0,115,0.05217391304347829
GPT-4o mini Transcribe,digit,200,0,11,211,0.05213270142180093
whisper-large-v3-turbo,driven,691,25,13,729,0.052126200274348444
GPT-4o mini Transcribe,viously,182,6,4,192,0.05208333333333337
GPT-4o mini Transcribe,down,894,27,22,943,0.051961823966065745
whisper-large-v3-turbo,available,73,1,3,77,0.051948051948051965
whisper-small,go,219,9,3,231,0.051948051948051965
GPT-4o mini Transcribe,go,219,9,3,231,0.051948051948051965
GPT-4o mini Transcribe,available,73,0,4,77,0.051948051948051965
whisper-large-v3-turbo,debt,1004,28,27,1059,0.05193578847969782
whisper-small,viously,183,6,4,193,0.051813471502590636
GPT-4o mini Transcribe,largely,55,3,0,58,0.051724137931034475
GPT-4o mini Transcribe,mid,110,6,0,116,0.051724137931034475
GPT-4o mini Transcribe,above,440,16,8,464,0.051724137931034475
whisper-large-v3-turbo,investor,55,3,0,58,0.051724137931034475
GPT-4o mini Transcribe,probably,110,3,3,116,0.051724137931034475
whisper-large-v3-turbo,provide,55,0,3,58,0.051724137931034475
whisper-large-v3-turbo,probably,110,3,3,116,0.051724137931034475
GPT-4o mini Transcribe,always,55,0,3,58,0.051724137931034475
whisper-small,impacts,55,0,3,58,0.051724137931034475
whisper-large-v3-turbo,largely,55,3,0,58,0.051724137931034475
whisper-small,investor,55,3,0,58,0.051724137931034475
whisper-small,efficiency,55,0,3,58,0.051724137931034475
whisper-small,always,55,3,0,58,0.051724137931034475
whisper-large-v3-turbo,impairment,55,3,0,58,0.051724137931034475
whisper-small,ratios,55,3,0,58,0.051724137931034475
GPT-4o mini Transcribe,investor,55,3,0,58,0.051724137931034475
whisper-large-v3-turbo,always,55,3,0,58,0.051724137931034475
whisper-small,while,495,12,15,522,0.051724137931034475
whisper-large-v3-turbo,example,55,0,3,58,0.051724137931034475
whisper-large-v3-turbo,mid,110,6,0,116,0.051724137931034475
GPT-4o mini Transcribe,increased,1561,45,40,1646,0.051640340218712
GPT-4o mini Transcribe,grew,848,24,22,894,0.05145413870246085
whisper-large-v3-turbo,return,498,21,6,525,0.05142857142857138
GPT-4o mini Transcribe,points,1128,36,25,1189,0.051303616484440706
whisper-small,turn,185,9,1,195,0.05128205128205132
GPT-4o mini Transcribe,new,537,18,11,566,0.051236749116607805
GPT-4o mini Transcribe,over,2078,77,35,2190,0.0511415525114155
whisper-small,sequential,130,0,7,137,0.051094890510948954
whisper-large-v3-turbo,barrel,223,12,0,235,0.051063829787234005
whisper-small,resulted,93,4,1,98,0.05102040816326525
whisper-large-v3-turbo,hi,56,3,0,59,0.05084745762711862
GPT-4o mini Transcribe,making,56,0,3,59,0.05084745762711862
GPT-4o mini Transcribe,retention,56,0,3,59,0.05084745762711862
whisper-large-v3-turbo,retention,56,0,3,59,0.05084745762711862
GPT-4o mini Transcribe,roughly,243,10,3,256,0.05078125
GPT-4o mini Transcribe,debt,991,25,28,1044,0.0507662835249042
whisper-large-v3-turbo,rates,206,7,4,217,0.05069124423963134
whisper-large-v3-turbo,ratio,731,30,9,770,0.05064935064935061
whisper-large-v3-turbo,these,600,25,7,632,0.05063291139240511
whisper-small,before,525,12,16,553,0.05063291139240511
GPT-4o mini Transcribe,part,150,4,4,158,0.05063291139240511
whisper-small,consecutive,75,1,3,79,0.05063291139240511
whisper-large-v3-turbo,quarters,282,12,3,297,0.0505050505050505
GPT-4o mini Transcribe,improvement,301,7,9,317,0.050473186119873836
whisper-small,asia,113,6,0,119,0.050420168067226934
GPT-4o mini Transcribe,global,132,1,6,139,0.05035971223021585
whisper-large-v3-turbo,achieved,189,6,4,199,0.05025125628140703
GPT-4o mini Transcribe,delivered,208,9,2,219,0.05022831050228316
GPT-4o mini Transcribe,your,643,18,16,677,0.05022156573116687
GPT-4o mini Transcribe,well,777,22,19,818,0.05012224938875309
whisper-large-v3-turbo,figure,114,3,3,120,0.050000000000000044
whisper-large-v3-turbo,great,95,3,2,100,0.050000000000000044
GPT-4o mini Transcribe,advances,57,0,3,60,0.050000000000000044
GPT-4o mini Transcribe,billings,57,0,3,60,0.050000000000000044
GPT-4o mini Transcribe,savings,76,0,4,80,0.050000000000000044
GPT-4o mini Transcribe,components,57,0,3,60,0.050000000000000044
whisper-large-v3-turbo,full,684,27,9,720,0.050000000000000044
whisper-large-v3-turbo,take,247,7,6,260,0.050000000000000044
whisper-large-v3-turbo,components,57,0,3,60,0.050000000000000044
whisper-small,billings,57,0,3,60,0.050000000000000044
GPT-4o mini Transcribe,digital,228,0,12,240,0.050000000000000044
GPT-4o mini Transcribe,material,57,0,3,60,0.050000000000000044
whisper-small,bp,57,0,3,60,0.050000000000000044
GPT-4o mini Transcribe,generating,76,0,4,80,0.050000000000000044
GPT-4o mini Transcribe,midpoint,57,0,3,60,0.050000000000000044
whisper-large-v3-turbo,slide,951,37,13,1001,0.049950049950049924
whisper-large-v3-turbo,revenue,3101,105,58,3264,0.04993872549019607
whisper-small,covid,381,10,10,401,0.04987531172069826
whisper-large-v3-turbo,demand,172,3,6,181,0.04972375690607733
GPT-4o mini Transcribe,some,442,16,7,465,0.04946236559139783
whisper-small,opportunities,77,3,1,81,0.04938271604938271
GPT-4o mini Transcribe,america,154,3,5,162,0.04938271604938271
whisper-small,europe,154,6,2,162,0.04938271604938271
whisper-small,versus,945,45,4,994,0.04929577464788737
whisper-large-v3-turbo,over,2084,76,32,2192,0.0492700729927007
GPT-4o mini Transcribe,slight,58,3,0,61,0.049180327868852514
GPT-4o mini Transcribe,beyond,116,3,3,122,0.049180327868852514
GPT-4o mini Transcribe,efficiency,58,0,3,61,0.049180327868852514
GPT-4o mini Transcribe,end,870,8,37,915,0.049180327868852514
whisper-small,largely,58,3,0,61,0.049180327868852514
whisper-large-v3-turbo,efficiency,58,0,3,61,0.049180327868852514
whisper-large-v3-turbo,gas,155,8,0,163,0.049079754601227044
whisper-large-v3-turbo,shows,136,3,4,143,0.04895104895104896
GPT-4o mini Transcribe,ratio,719,28,9,756,0.04894179894179895
whisper-large-v3-turbo,estimated,78,0,4,82,0.04878048780487809
whisper-large-v3-turbo,gmv,117,6,0,123,0.04878048780487809
whisper-small,investments,195,3,7,205,0.04878048780487809
GPT-4o mini Transcribe,dont,117,6,0,123,0.04878048780487809
whisper-large-v3-turbo,time,468,13,11,492,0.04878048780487809
whisper-small,already,254,10,3,267,0.048689138576779034
GPT-4o mini Transcribe,since,254,9,4,267,0.048689138576779034
GPT-4o mini Transcribe,look,391,7,13,411,0.048661800486618056
GPT-4o mini Transcribe,earlier,196,6,4,206,0.04854368932038833
whisper-large-v3-turbo,really,255,8,5,268,0.04850746268656714
whisper-large-v3-turbo,break,59,0,3,62,0.048387096774193505
whisper-small,once,59,0,3,62,0.048387096774193505
GPT-4o mini Transcribe,opportunity,59,3,0,62,0.048387096774193505
GPT-4o mini Transcribe,said,295,12,3,310,0.048387096774193505
GPT-4o mini Transcribe,planning,59,0,3,62,0.048387096774193505
GPT-4o mini Transcribe,free,630,13,19,662,0.048338368580060465
whisper-large-v3-turbo,believe,138,3,4,145,0.0482758620689655
GPT-4o mini Transcribe,its,1242,21,42,1305,0.0482758620689655
whisper-small,including,415,10,11,436,0.04816513761467889
whisper-small,plan,178,3,6,187,0.048128342245989275
whisper-small,full,694,22,13,729,0.0480109739368999
whisper-small,similar,119,3,3,125,0.04800000000000004
GPT-4o mini Transcribe,marketing,119,6,0,125,0.04800000000000004
whisper-large-v3-turbo,q2,319,13,3,335,0.047761194029850795
whisper-large-v3-turbo,organic,738,28,9,775,0.047741935483870956
GPT-4o mini Transcribe,are,1957,49,49,2055,0.04768856447688563
whisper-large-v3-turbo,material,60,0,3,63,0.04761904761904767
whisper-large-v3-turbo,loans,140,6,1,147,0.04761904761904767
whisper-small,material,60,0,3,63,0.04761904761904767
GPT-4o mini Transcribe,ago,280,10,4,294,0.04761904761904767
whisper-large-v3-turbo,ghana,60,3,0,63,0.04761904761904767
whisper-large-v3-turbo,ev,60,3,0,63,0.04761904761904767
whisper-large-v3-turbo,done,60,3,0,63,0.04761904761904767
GPT-4o mini Transcribe,gigawatts,60,0,3,63,0.04761904761904767
whisper-large-v3-turbo,adjustment,60,0,3,63,0.04761904761904767
GPT-4o mini Transcribe,ghana,60,0,3,63,0.04761904761904767
GPT-4o mini Transcribe,win,120,0,6,126,0.04761904761904767
GPT-4o mini Transcribe,talked,60,0,3,63,0.04761904761904767
GPT-4o mini Transcribe,years,882,25,19,926,0.04751619870410362
GPT-4o mini Transcribe,date,202,3,7,212,0.047169811320754707
GPT-4o mini Transcribe,know,1052,30,22,1104,0.047101449275362306
GPT-4o mini Transcribe,quarters,263,4,9,276,0.047101449275362306
whisper-small,since,263,9,4,276,0.047101449275362306
whisper-large-v3-turbo,closed,81,3,1,85,0.04705882352941182
GPT-4o mini Transcribe,example,61,0,3,64,0.046875
GPT-4o mini Transcribe,basis,1159,24,33,1216,0.046875
whisper-large-v3-turbo,used,61,3,0,64,0.046875
whisper-large-v3-turbo,r,61,3,0,64,0.046875
whisper-small,middle,61,3,0,64,0.046875
whisper-small,slight,61,3,0,64,0.046875
whisper-large-v3-turbo,slight,61,3,0,64,0.046875
whisper-small,used,61,3,0,64,0.046875
whisper-large-v3-turbo,anticipated,61,3,0,64,0.046875
whisper-small,marketing,122,6,0,128,0.046875
GPT-4o mini Transcribe,r,61,3,0,64,0.046875
GPT-4o mini Transcribe,consider,61,0,3,64,0.046875
whisper-large-v3-turbo,profits,61,3,0,64,0.046875
GPT-4o mini Transcribe,number,489,6,18,513,0.04678362573099415
whisper-small,welcome,143,3,4,150,0.046666666666666634
GPT-4o mini Transcribe,loans,143,3,4,150,0.046666666666666634
GPT-4o mini Transcribe,decrease,327,16,0,343,0.04664723032069973
whisper-large-v3-turbo,mainly,450,9,13,472,0.04661016949152541
GPT-4o mini Transcribe,targets,82,0,4,86,0.046511627906976716
whisper-large-v3-turbo,most,123,0,6,129,0.046511627906976716
whisper-large-v3-turbo,win,123,0,6,129,0.046511627906976716
GPT-4o mini Transcribe,growth,5217,138,116,5471,0.04642661305063056
whisper-large-v3-turbo,amounted,185,6,3,194,0.046391752577319534
whisper-large-v3-turbo,provided,103,5,0,108,0.04629629629629628
GPT-4o mini Transcribe,another,206,7,3,216,0.04629629629629628
GPT-4o mini Transcribe,provided,103,5,0,108,0.04629629629629628
GPT-4o mini Transcribe,growing,248,6,6,260,0.0461538461538461
whisper-small,several,62,3,0,65,0.0461538461538461
whisper-large-v3-turbo,minus,186,6,3,195,0.0461538461538461
GPT-4o mini Transcribe,rest,62,3,0,65,0.0461538461538461
whisper-small,world,62,3,0,65,0.0461538461538461
GPT-4o mini Transcribe,increasing,249,6,6,261,0.04597701149425293
GPT-4o mini Transcribe,maybe,166,6,2,174,0.04597701149425293
GPT-4o mini Transcribe,pay,83,3,1,87,0.04597701149425293
GPT-4o mini Transcribe,q2,291,4,10,305,0.04590163934426228
GPT-4o mini Transcribe,exchange,250,3,9,262,0.04580152671755722
GPT-4o mini Transcribe,would,731,22,13,766,0.04569190600522188
GPT-4o mini Transcribe,no,209,7,3,219,0.045662100456621
whisper-small,continued,314,12,3,329,0.045592705167173286
GPT-4o mini Transcribe,expense,189,4,5,198,0.045454545454545414
whisper-large-v3-turbo,greater,63,0,3,66,0.045454545454545414
GPT-4o mini Transcribe,projects,105,4,1,110,0.045454545454545414
whisper-small,ev,63,3,0,66,0.045454545454545414
whisper-large-v3-turbo,groups,63,3,0,66,0.045454545454545414
GPT-4o mini Transcribe,greater,63,0,3,66,0.045454545454545414
whisper-large-v3-turbo,gigawatts,63,0,3,66,0.045454545454545414
whisper-small,support,84,4,0,88,0.045454545454545414
GPT-4o mini Transcribe,return,504,22,2,528,0.045454545454545414
whisper-large-v3-turbo,before,528,6,19,553,0.0452079566003617
GPT-4o mini Transcribe,see,866,24,17,907,0.04520396912899671
GPT-4o mini Transcribe,recovery,127,6,0,133,0.045112781954887216
whisper-large-v3-turbo,should,360,7,10,377,0.04509283819628651
GPT-4o mini Transcribe,need,85,3,1,89,0.0449438202247191
GPT-4o mini Transcribe,april,85,3,1,89,0.0449438202247191
GPT-4o mini Transcribe,sector,64,3,0,67,0.04477611940298509
GPT-4o mini Transcribe,consistent,64,3,0,67,0.04477611940298509
whisper-small,consider,64,0,3,67,0.04477611940298509
GPT-4o mini Transcribe,bps,64,0,3,67,0.04477611940298509
whisper-large-v3-turbo,december,321,12,3,336,0.044642857142857095
whisper-large-v3-turbo,profitability,193,9,0,202,0.044554455445544594
GPT-4o mini Transcribe,month,236,7,4,247,0.04453441295546556
GPT-4o mini Transcribe,can,644,15,15,674,0.04451038575667654
whisper-large-v3-turbo,portfolio,172,4,4,180,0.0444444444444444
whisper-large-v3-turbo,delivered,215,9,1,225,0.0444444444444444
GPT-4o mini Transcribe,offset,129,6,0,135,0.0444444444444444
GPT-4o mini Transcribe,yeah,259,6,6,271,0.044280442804428
whisper-large-v3-turbo,purchase,108,2,3,113,0.04424778761061943
whisper-large-v3-turbo,ago,281,11,2,294,0.04421768707482998
whisper-large-v3-turbo,today,238,6,5,249,0.04417670682730923
GPT-4o mini Transcribe,plus,541,14,11,566,0.044169611307420475
GPT-4o mini Transcribe,partially,65,3,0,68,0.044117647058823484
GPT-4o mini Transcribe,comes,130,6,0,136,0.044117647058823484
whisper-large-v3-turbo,provision,65,0,3,68,0.044117647058823484
whisper-large-v3-turbo,perspective,65,0,3,68,0.044117647058823484
whisper-small,local,65,3,0,68,0.044117647058823484
whisper-large-v3-turbo,contract,65,0,3,68,0.044117647058823484
GPT-4o mini Transcribe,contract,65,0,3,68,0.044117647058823484
whisper-large-v3-turbo,guiding,65,0,3,68,0.044117647058823484
whisper-large-v3-turbo,special,87,0,4,91,0.04395604395604391
whisper-large-v3-turbo,here,327,9,6,342,0.04385964912280704
whisper-small,taking,109,2,3,114,0.04385964912280704
GPT-4o mini Transcribe,i,2313,47,59,2419,0.04381976023150058
whisper-large-v3-turbo,sequential,131,0,6,137,0.04379562043795615
GPT-4o mini Transcribe,sequential,131,0,6,137,0.04379562043795615
whisper-small,accounting,66,3,0,69,0.04347826086956519
whisper-small,decreasing,66,0,3,69,0.04347826086956519
whisper-large-v3-turbo,remarkable,66,3,0,69,0.04347826086956519
GPT-4o mini Transcribe,impacted,132,6,0,138,0.04347826086956519
whisper-small,luminex,66,3,0,69,0.04347826086956519
GPT-4o mini Transcribe,equipment,66,0,3,69,0.04347826086956519
GPT-4o mini Transcribe,ex,66,0,3,69,0.04347826086956519
whisper-large-v3-turbo,april,88,4,0,92,0.04347826086956519
GPT-4o mini Transcribe,enterprise,66,0,3,69,0.04347826086956519
GPT-4o mini Transcribe,accounting,66,3,0,69,0.04347826086956519
whisper-large-v3-turbo,segment,419,10,9,438,0.04337899543378998
whisper-large-v3-turbo,reported,332,8,7,347,0.043227665706051854
whisper-small,america,155,1,6,162,0.043209876543209846
GPT-4o mini Transcribe,non,399,8,10,417,0.043165467625899234
GPT-4o mini Transcribe,business,932,25,17,974,0.043121149897330624
GPT-4o mini Transcribe,within,178,7,1,186,0.043010752688172005
GPT-4o mini Transcribe,step,89,3,1,93,0.043010752688172005
whisper-small,opex,67,0,3,70,0.042857142857142816
GPT-4o mini Transcribe,talking,67,3,0,70,0.042857142857142816
GPT-4o mini Transcribe,financing,67,0,3,70,0.042857142857142816
whisper-large-v3-turbo,consistent,67,3,0,70,0.042857142857142816
GPT-4o mini Transcribe,february,67,0,3,70,0.042857142857142816
whisper-large-v3-turbo,seeing,67,0,3,70,0.042857142857142816
whisper-large-v3-turbo,equipment,67,0,3,70,0.042857142857142816
GPT-4o mini Transcribe,stands,67,0,3,70,0.042857142857142816
GPT-4o mini Transcribe,profits,67,0,3,70,0.042857142857142816
whisper-small,changes,67,3,0,70,0.042857142857142816
whisper-large-v3-turbo,opex,67,0,3,70,0.042857142857142816
whisper-small,stands,67,0,3,70,0.042857142857142816
whisper-large-v3-turbo,therefore,134,3,3,140,0.042857142857142816
whisper-large-v3-turbo,do,291,10,3,304,0.042763157894736836
whisper-large-v3-turbo,program,180,7,1,188,0.04255319148936165
whisper-small,credit,181,8,0,189,0.042328042328042326
GPT-4o mini Transcribe,expectation,68,0,3,71,0.04225352112676062
whisper-large-v3-turbo,every,68,0,3,71,0.04225352112676062
whisper-small,consumer,68,0,3,71,0.04225352112676062
GPT-4o mini Transcribe,consumer,68,3,0,71,0.04225352112676062
GPT-4o mini Transcribe,every,68,0,3,71,0.04225352112676062
whisper-large-v3-turbo,partially,68,3,0,71,0.04225352112676062
whisper-small,need,91,0,4,95,0.04210526315789476
whisper-large-v3-turbo,fact,91,4,0,95,0.04210526315789476
GPT-4o mini Transcribe,really,251,4,7,262,0.041984732824427495
whisper-large-v3-turbo,ebit,298,6,7,311,0.04180064308681675
whisper-large-v3-turbo,just,942,25,16,983,0.04170905391658186
GPT-4o mini Transcribe,reasons,69,0,3,72,0.04166666666666663
whisper-small,trend,92,3,1,96,0.04166666666666663
GPT-4o mini Transcribe,includes,138,0,6,144,0.04166666666666663
GPT-4o mini Transcribe,solid,207,0,9,216,0.04166666666666663
GPT-4o mini Transcribe,sga,69,0,3,72,0.04166666666666663
whisper-large-v3-turbo,sga,69,0,3,72,0.04166666666666663
GPT-4o mini Transcribe,between,553,7,17,577,0.04159445407279028
whisper-small,reduction,231,5,5,241,0.04149377593360992
GPT-4o mini Transcribe,reduction,231,5,5,241,0.04149377593360992
whisper-large-v3-turbo,items,139,0,6,145,0.04137931034482756
whisper-small,items,139,3,3,145,0.04137931034482756
GPT-4o mini Transcribe,items,139,0,6,145,0.04137931034482756
GPT-4o mini Transcribe,main,232,0,10,242,0.04132231404958675
GPT-4o mini Transcribe,rate,977,33,9,1019,0.04121687929342488
GPT-4o mini Transcribe,if,863,12,25,900,0.0411111111111111
GPT-4o mini Transcribe,highlights,70,0,3,73,0.04109589041095896
whisper-large-v3-turbo,talking,70,3,0,73,0.04109589041095896
whisper-small,financing,70,0,3,73,0.04109589041095896
whisper-small,division,70,0,3,73,0.04109589041095896
whisper-large-v3-turbo,financing,70,0,3,73,0.04109589041095896
whisper-large-v3-turbo,highlights,70,0,3,73,0.04109589041095896
GPT-4o mini Transcribe,restructuring,70,0,3,73,0.04109589041095896
whisper-small,highlights,70,3,0,73,0.04109589041095896
whisper-large-v3-turbo,no,211,6,3,220,0.040909090909090895
whisper-large-v3-turbo,solutions,94,3,1,98,0.04081632653061229
GPT-4o mini Transcribe,there,542,12,11,565,0.04070796460176995
GPT-4o mini Transcribe,compare,71,3,0,74,0.04054054054054057
whisper-large-v3-turbo,expenditures,71,3,0,74,0.04054054054054057
whisper-small,expenditures,71,3,0,74,0.04054054054054057
GPT-4o mini Transcribe,before,522,3,19,544,0.0404411764705882
whisper-large-v3-turbo,transactions,95,3,1,99,0.04040404040404044
GPT-4o mini Transcribe,generate,95,3,1,99,0.04040404040404044
GPT-4o mini Transcribe,just,928,17,22,967,0.04033092037228547
whisper-small,initiatives,72,0,3,75,0.040000000000000036
whisper-small,remaining,72,3,0,75,0.040000000000000036
whisper-large-v3-turbo,welcome,144,3,3,150,0.040000000000000036
whisper-small,care,72,3,0,75,0.040000000000000036
whisper-small,restructuring,72,0,3,75,0.040000000000000036
GPT-4o mini Transcribe,showing,72,0,3,75,0.040000000000000036
GPT-4o mini Transcribe,great,96,4,0,100,0.040000000000000036
whisper-large-v3-turbo,restructuring,72,0,3,75,0.040000000000000036
whisper-large-v3-turbo,includes,144,6,0,150,0.040000000000000036
GPT-4o mini Transcribe,balance,313,10,3,326,0.039877300613496924
whisper-small,large,97,3,1,101,0.03960396039603964
GPT-4o mini Transcribe,line,558,13,10,581,0.03958691910499135
whisper-large-v3-turbo,participants,73,0,3,76,0.03947368421052633
whisper-small,them,73,3,0,76,0.03947368421052633
GPT-4o mini Transcribe,participants,73,0,3,76,0.03947368421052633
whisper-small,particularly,73,3,0,76,0.03947368421052633
whisper-large-v3-turbo,turning,171,0,7,178,0.0393258426966292
GPT-4o mini Transcribe,figures,147,6,0,153,0.039215686274509776
GPT-4o mini Transcribe,recent,49,0,2,51,0.039215686274509776
whisper-large-v3-turbo,something,147,0,6,153,0.039215686274509776
GPT-4o mini Transcribe,being,221,9,0,230,0.03913043478260869
whisper-large-v3-turbo,lets,320,4,9,333,0.03903903903903905
whisper-small,order,148,6,0,154,0.038961038961038974
whisper-small,youve,74,0,3,77,0.038961038961038974
whisper-large-v3-turbo,go,222,6,3,231,0.038961038961038974
GPT-4o mini Transcribe,planned,74,0,3,77,0.038961038961038974
GPT-4o mini Transcribe,gave,74,0,3,77,0.038961038961038974
GPT-4o mini Transcribe,organic,741,15,15,771,0.03891050583657585
whisper-small,focus,99,3,1,103,0.03883495145631066
whisper-small,difference,50,2,0,52,0.038461538461538436
whisper-large-v3-turbo,difference,50,2,0,52,0.038461538461538436
whisper-large-v3-turbo,delivery,75,3,0,78,0.038461538461538436
whisper-large-v3-turbo,planned,75,0,3,78,0.038461538461538436
GPT-4o mini Transcribe,difference,50,2,0,52,0.038461538461538436
whisper-small,affected,75,0,3,78,0.038461538461538436
whisper-large-v3-turbo,years,878,21,14,913,0.03833515881708649
whisper-large-v3-turbo,while,502,7,13,522,0.03831417624521072
GPT-4o mini Transcribe,barrel,226,6,3,235,0.03829787234042559
GPT-4o mini Transcribe,orders,126,4,1,131,0.03816793893129766
GPT-4o mini Transcribe,customers,101,1,3,105,0.03809523809523807
whisper-large-v3-turbo,affected,76,0,3,79,0.03797468354430378
whisper-large-v3-turbo,too,76,3,0,79,0.03797468354430378
whisper-large-v3-turbo,especially,76,0,3,79,0.03797468354430378
GPT-4o mini Transcribe,affected,76,0,3,79,0.03797468354430378
GPT-4o mini Transcribe,conversion,76,3,0,79,0.03797468354430378
GPT-4o mini Transcribe,say,304,6,6,316,0.03797468354430378
GPT-4o mini Transcribe,times,406,9,7,422,0.03791469194312791
GPT-4o mini Transcribe,amount,178,6,1,185,0.037837837837837784
whisper-large-v3-turbo,contracts,51,0,2,53,0.037735849056603765
GPT-4o mini Transcribe,actions,51,0,2,53,0.037735849056603765
GPT-4o mini Transcribe,contracts,51,1,1,53,0.037735849056603765
GPT-4o mini Transcribe,effect,153,0,6,159,0.037735849056603765
whisper-large-v3-turbo,bringing,77,3,0,80,0.03749999999999998
whisper-large-v3-turbo,conversion,77,3,0,80,0.03749999999999998
whisper-large-v3-turbo,youve,77,3,0,80,0.03749999999999998
GPT-4o mini Transcribe,fiscal,1104,25,18,1147,0.037489102005231034
whisper-large-v3-turbo,allocation,129,3,2,134,0.03731343283582089
whisper-small,other,595,9,14,618,0.03721682847896435
GPT-4o mini Transcribe,but,1141,28,16,1185,0.037130801687763726
whisper-large-v3-turbo,declined,234,6,3,243,0.03703703703703709
whisper-large-v3-turbo,solid,208,3,5,216,0.03703703703703709
GPT-4o mini Transcribe,mobile,156,6,0,162,0.03703703703703709
GPT-4o mini Transcribe,rotation,79,0,3,82,0.03658536585365857
whisper-small,spend,79,3,0,82,0.03658536585365857
GPT-4o mini Transcribe,november,79,0,3,82,0.03658536585365857
whisper-large-v3-turbo,effects,79,3,0,82,0.03658536585365857
GPT-4o mini Transcribe,continued,317,12,0,329,0.03647416413373861
GPT-4o mini Transcribe,activities,185,4,3,192,0.03645833333333337
whisper-small,quarterly,291,4,7,302,0.03642384105960261
whisper-large-v3-turbo,actions,53,0,2,55,0.036363636363636376
whisper-large-v3-turbo,viously,186,6,1,193,0.03626943005181349
GPT-4o mini Transcribe,mainly,426,6,10,442,0.03619909502262442
GPT-4o mini Transcribe,basic,80,3,0,83,0.03614457831325302
whisper-large-v3-turbo,november,80,0,3,83,0.03614457831325302
whisper-small,november,80,3,0,83,0.03614457831325302
GPT-4o mini Transcribe,going,480,13,5,498,0.03614457831325302
whisper-large-v3-turbo,activity,107,4,0,111,0.036036036036036
whisper-large-v3-turbo,comparable,107,0,4,111,0.036036036036036
GPT-4o mini Transcribe,comparable,107,0,4,111,0.036036036036036
whisper-small,comparable,107,0,4,111,0.036036036036036
whisper-large-v3-turbo,activities,188,4,3,195,0.03589743589743588
GPT-4o mini Transcribe,sort,135,3,2,140,0.0357142857142857
GPT-4o mini Transcribe,maintenance,81,3,0,84,0.0357142857142857
whisper-small,contracts,54,1,1,56,0.0357142857142857
GPT-4o mini Transcribe,moving,324,7,5,336,0.0357142857142857
GPT-4o mini Transcribe,percentage,567,9,12,588,0.0357142857142857
whisper-large-v3-turbo,user,81,0,3,84,0.0357142857142857
GPT-4o mini Transcribe,start,190,4,3,197,0.035532994923857864
whisper-large-v3-turbo,underlying,272,0,10,282,0.03546099290780147
whisper-small,areas,109,3,1,113,0.03539823008849563
GPT-4o mini Transcribe,areas,109,0,4,113,0.03539823008849563
GPT-4o mini Transcribe,worth,82,0,3,85,0.03529411764705881
whisper-small,whole,82,3,0,85,0.03529411764705881
GPT-4o mini Transcribe,investments,192,6,1,199,0.035175879396984966
whisper-large-v3-turbo,kind,110,1,3,114,0.03508771929824561
GPT-4o mini Transcribe,organically,165,6,0,171,0.03508771929824561
whisper-large-v3-turbo,growing,248,9,0,257,0.035019455252918275
whisper-large-v3-turbo,services,248,6,3,257,0.035019455252918275
whisper-large-v3-turbo,basic,83,3,0,86,0.03488372093023251
GPT-4o mini Transcribe,industry,83,3,0,86,0.03488372093023251
whisper-small,industry,83,3,0,86,0.03488372093023251
GPT-4o mini Transcribe,services,250,6,3,259,0.03474903474903479
whisper-small,constant,167,6,0,173,0.034682080924855474
whisper-small,reported,335,7,5,347,0.03458213256484155
GPT-4o mini Transcribe,case,112,0,4,116,0.03448275862068961
whisper-small,top,252,6,3,261,0.03448275862068961
whisper-small,expanded,84,3,0,87,0.03448275862068961
whisper-large-v3-turbo,outstanding,56,1,1,58,0.03448275862068961
whisper-small,outstanding,56,1,1,58,0.03448275862068961
GPT-4o mini Transcribe,outstanding,56,1,1,58,0.03448275862068961
GPT-4o mini Transcribe,already,252,9,0,261,0.03448275862068961
GPT-4o mini Transcribe,yoy,84,3,0,87,0.03448275862068961
GPT-4o mini Transcribe,transaction,112,3,1,116,0.03448275862068961
GPT-4o mini Transcribe,investment,226,4,4,234,0.03418803418803418
GPT-4o mini Transcribe,support,85,3,0,88,0.03409090909090906
GPT-4o mini Transcribe,volumes,170,2,4,176,0.03409090909090906
GPT-4o mini Transcribe,current,314,7,4,325,0.03384615384615386
GPT-4o mini Transcribe,stood,172,3,3,178,0.0337078651685393
whisper-small,add,86,3,0,89,0.0337078651685393
whisper-small,case,115,0,4,119,0.03361344537815125
whisper-large-v3-turbo,case,115,0,4,119,0.03361344537815125
whisper-large-v3-turbo,grow,260,6,3,269,0.03345724907063197
GPT-4o mini Transcribe,construction,87,0,3,90,0.033333333333333326
GPT-4o mini Transcribe,giving,87,3,0,90,0.033333333333333326
GPT-4o mini Transcribe,rupees,87,0,3,90,0.033333333333333326
GPT-4o mini Transcribe,backlog,87,3,0,90,0.033333333333333326
GPT-4o mini Transcribe,demand,175,3,3,181,0.03314917127071826
GPT-4o mini Transcribe,question,381,7,6,394,0.032994923857868064
whisper-large-v3-turbo,everyone,88,3,0,91,0.03296703296703296
whisper-large-v3-turbo,profile,88,0,3,91,0.03296703296703296
whisper-small,until,88,1,2,91,0.03296703296703296
GPT-4o mini Transcribe,special,88,0,3,91,0.03296703296703296
whisper-small,everyone,88,3,0,91,0.03296703296703296
whisper-large-v3-turbo,decline,294,7,3,304,0.03289473684210531
whisper-small,margins,265,6,3,274,0.03284671532846717
whisper-large-v3-turbo,backlog,89,0,3,92,0.03260869565217395
whisper-large-v3-turbo,covid,388,3,10,401,0.032418952618453845
GPT-4o mini Transcribe,operations,270,5,4,279,0.032258064516129004
whisper-large-v3-turbo,operations,270,7,2,279,0.032258064516129004
whisper-large-v3-turbo,international,90,0,3,93,0.032258064516129004
whisper-small,international,90,0,3,93,0.032258064516129004
GPT-4o mini Transcribe,morning,180,0,6,186,0.032258064516129004
GPT-4o mini Transcribe,respectively,302,4,6,312,0.03205128205128205
GPT-4o mini Transcribe,delivering,91,3,0,94,0.03191489361702127
GPT-4o mini Transcribe,expectations,91,3,0,94,0.03191489361702127
whisper-large-v3-turbo,including,426,8,6,440,0.03181818181818186
whisper-large-v3-turbo,inr,183,6,0,189,0.031746031746031744
whisper-large-v3-turbo,talked,61,0,2,63,0.031746031746031744
whisper-small,health,92,3,0,95,0.03157894736842104
GPT-4o mini Transcribe,active,92,0,3,95,0.03157894736842104
GPT-4o mini Transcribe,october,92,0,3,95,0.03157894736842104
whisper-large-v3-turbo,october,92,0,3,95,0.03157894736842104
whisper-large-v3-turbo,colombia,92,3,0,95,0.03157894736842104
whisper-large-v3-turbo,expectations,92,3,0,95,0.03157894736842104
GPT-4o mini Transcribe,could,215,1,6,222,0.03153153153153154
whisper-large-v3-turbo,numbers,185,0,6,191,0.03141361256544506
whisper-large-v3-turbo,lastly,62,0,2,64,0.03125
whisper-small,central,93,0,3,96,0.03125
whisper-large-v3-turbo,central,93,0,3,96,0.03125
whisper-large-v3-turbo,segments,155,2,3,160,0.03125
GPT-4o mini Transcribe,accounted,93,0,3,96,0.03125
whisper-small,accounted,93,3,0,96,0.03125
whisper-small,remained,126,0,4,130,0.03076923076923077
whisper-large-v3-turbo,relative,63,1,1,65,0.03076923076923077
GPT-4o mini Transcribe,relative,63,1,1,65,0.03076923076923077
GPT-4o mini Transcribe,while,505,6,10,521,0.030710172744721653
GPT-4o mini Transcribe,lets,316,1,9,326,0.030674846625766916
GPT-4o mini Transcribe,until,95,0,3,98,0.030612244897959218
whisper-small,active,95,3,0,98,0.030612244897959218
whisper-small,solutions,95,3,0,98,0.030612244897959218
whisper-small,percentage,576,15,3,594,0.030303030303030276
whisper-large-v3-turbo,factors,96,3,0,99,0.030303030303030276
whisper-large-v3-turbo,percentage,576,12,6,594,0.030303030303030276
whisper-small,allocation,129,3,1,133,0.03007518796992481
GPT-4o mini Transcribe,future,97,0,3,100,0.030000000000000027
whisper-small,great,97,3,0,100,0.030000000000000027
GPT-4o mini Transcribe,achieved,196,0,6,202,0.02970297029702973
whisper-small,profitability,196,6,0,202,0.02970297029702973
whisper-small,most,131,1,3,135,0.029629629629629672
whisper-large-v3-turbo,however,197,6,0,203,0.029556650246305383
whisper-large-v3-turbo,quarterly,296,7,2,305,0.02950819672131144
GPT-4o mini Transcribe,factors,99,3,0,102,0.02941176470588236
whisper-large-v3-turbo,expecting,99,0,3,102,0.02941176470588236
whisper-large-v3-turbo,fy21,99,3,0,102,0.02941176470588236
GPT-4o mini Transcribe,expecting,99,0,3,102,0.02941176470588236
whisper-small,expecting,99,0,3,102,0.02941176470588236
whisper-small,factors,99,3,0,102,0.02941176470588236
whisper-large-v3-turbo,different,99,3,0,102,0.02941176470588236
whisper-large-v3-turbo,investments,199,3,3,205,0.029268292682926855
whisper-small,significantly,166,2,3,171,0.0292397660818714
whisper-large-v3-turbo,highest,100,3,0,103,0.029126213592232997
GPT-4o mini Transcribe,highest,100,0,3,103,0.029126213592232997
GPT-4o mini Transcribe,risk,201,6,0,207,0.02898550724637683
GPT-4o mini Transcribe,foreign,67,0,2,69,0.02898550724637683
whisper-large-v3-turbo,respectively,303,4,5,312,0.028846153846153855
whisper-large-v3-turbo,starting,102,3,0,105,0.02857142857142858
whisper-small,represent,102,0,3,105,0.02857142857142858
GPT-4o mini Transcribe,report,68,0,2,70,0.02857142857142858
whisper-large-v3-turbo,future,103,0,3,106,0.028301886792452824
GPT-4o mini Transcribe,segment,413,6,6,425,0.028235294117647025
whisper-small,every,69,0,2,71,0.028169014084507005
whisper-large-v3-turbo,partners,69,1,1,71,0.028169014084507005
whisper-large-v3-turbo,risk,207,0,6,213,0.028169014084507005
whisper-small,invested,104,3,0,107,0.028037383177570097
whisper-large-v3-turbo,drivers,140,4,0,144,0.02777777777777779
GPT-4o mini Transcribe,drivers,140,4,0,144,0.02777777777777779
whisper-small,portfolio,175,3,2,180,0.02777777777777779
whisper-small,work,106,3,0,109,0.02752293577981646
whisper-large-v3-turbo,report,71,0,2,73,0.0273972602739726
whisper-small,sale,71,0,2,73,0.0273972602739726
whisper-small,segment,426,3,9,438,0.0273972602739726
whisper-large-v3-turbo,rise,144,3,1,148,0.027027027027026973
GPT-4o mini Transcribe,believe,144,0,4,148,0.027027027027026973
GPT-4o mini Transcribe,activity,108,0,3,111,0.027027027027026973
GPT-4o mini Transcribe,estimate,217,3,3,223,0.026905829596412523
whisper-large-v3-turbo,im,181,1,4,186,0.026881720430107503
whisper-small,leverage,218,1,5,224,0.0267857142857143
whisper-large-v3-turbo,leverage,218,4,2,224,0.0267857142857143
GPT-4o mini Transcribe,show,109,0,3,112,0.0267857142857143
whisper-large-v3-turbo,initiatives,73,0,2,75,0.026666666666666616
GPT-4o mini Transcribe,slide,950,13,13,976,0.026639344262295084
whisper-large-v3-turbo,show,110,0,3,113,0.026548672566371723
GPT-4o mini Transcribe,credit,184,1,4,189,0.02645502645502651
whisper-large-v3-turbo,credit,184,4,1,189,0.02645502645502651
whisper-small,mean,258,3,4,265,0.026415094339622636
whisper-small,category,111,3,0,114,0.02631578947368418
whisper-small,here,333,3,6,342,0.02631578947368418
whisper-large-v3-turbo,monthly,113,3,0,116,0.025862068965517238
whisper-small,monthly,113,3,0,116,0.025862068965517238
GPT-4o mini Transcribe,monthly,113,3,0,116,0.025862068965517238
whisper-large-v3-turbo,question,377,10,0,387,0.025839793281653756
GPT-4o mini Transcribe,leading,114,3,0,117,0.02564102564102566
GPT-4o mini Transcribe,page,267,0,7,274,0.025547445255474477
GPT-4o mini Transcribe,turn,191,1,4,196,0.025510204081632626
GPT-4o mini Transcribe,project,77,1,1,79,0.025316455696202556
GPT-4o mini Transcribe,should,347,6,3,356,0.0252808988764045
whisper-large-v3-turbo,asia,116,3,0,119,0.025210084033613467
GPT-4o mini Transcribe,figure,117,3,0,120,0.025000000000000022
GPT-4o mini Transcribe,least,117,3,0,120,0.025000000000000022
whisper-large-v3-turbo,digital,234,6,0,240,0.025000000000000022
whisper-large-v3-turbo,reduction,235,4,2,241,0.024896265560165998
GPT-4o mini Transcribe,big,118,3,0,121,0.024793388429752095
whisper-large-v3-turbo,america,158,0,4,162,0.024691358024691357
whisper-large-v3-turbo,opportunities,79,2,0,81,0.024691358024691357
whisper-large-v3-turbo,beyond,119,3,0,122,0.024590163934426257
GPT-4o mini Transcribe,account,120,3,0,123,0.024390243902439046
whisper-large-v3-turbo,other,600,9,6,615,0.024390243902439046
GPT-4o mini Transcribe,gmv,120,0,3,123,0.024390243902439046
whisper-large-v3-turbo,loan,161,4,0,165,0.024242424242424288
GPT-4o mini Transcribe,loan,161,3,1,165,0.024242424242424288
whisper-large-v3-turbo,expense,202,3,2,207,0.024154589371980673
whisper-large-v3-turbo,similar,122,3,0,125,0.02400000000000002
GPT-4o mini Transcribe,forward,164,4,0,168,0.023809523809523836
GPT-4o mini Transcribe,top,252,0,6,258,0.023255813953488413
GPT-4o mini Transcribe,program,169,3,1,173,0.023121387283236983
GPT-4o mini Transcribe,grow,257,0,6,263,0.02281368821292773
whisper-large-v3-turbo,until,86,0,2,88,0.022727272727272707
GPT-4o mini Transcribe,most,129,3,0,132,0.022727272727272707
whisper-large-v3-turbo,mean,259,3,3,265,0.02264150943396226
whisper-small,customer,130,3,0,133,0.022556390977443663
whisper-small,respectively,305,4,3,312,0.022435897435897467
whisper-large-v3-turbo,margins,262,6,0,268,0.02238805970149249
GPT-4o mini Transcribe,move,131,0,3,134,0.02238805970149249
whisper-large-v3-turbo,best,88,1,1,90,0.022222222222222254
whisper-small,profile,89,2,0,91,0.02197802197802201
whisper-large-v3-turbo,saw,226,2,3,231,0.02164502164502169
whisper-small,combined,91,1,1,93,0.021505376344086002
GPT-4o mini Transcribe,customer,139,3,0,142,0.021126760563380254
whisper-small,off,190,0,4,194,0.020618556701030966
whisper-large-v3-turbo,resulted,96,0,2,98,0.020408163265306145
whisper-large-v3-turbo,31st,96,1,1,98,0.020408163265306145
GPT-4o mini Transcribe,declined,241,0,5,246,0.020325203252032575
whisper-small,includes,147,0,3,150,0.020000000000000018
whisper-small,corporate,98,0,2,100,0.020000000000000018
whisper-large-v3-turbo,area,149,3,0,152,0.019736842105263164
whisper-small,categories,50,0,1,51,0.019607843137254943
GPT-4o mini Transcribe,dividends,150,3,0,153,0.019607843137254943
whisper-large-v3-turbo,units,151,3,0,154,0.01948051948051943
GPT-4o mini Transcribe,units,151,2,1,154,0.01948051948051943
whisper-small,effect,152,0,3,155,0.01935483870967747
whisper-large-v3-turbo,continues,153,3,0,156,0.019230769230769273
GPT-4o mini Transcribe,increases,153,2,1,156,0.019230769230769273
whisper-large-v3-turbo,increases,153,2,1,156,0.019230769230769273
whisper-large-v3-turbo,dividends,153,0,3,156,0.019230769230769273
whisper-large-v3-turbo,say,313,3,3,319,0.018808777429467072
whisper-large-v3-turbo,date,211,0,4,215,0.018604651162790753
whisper-large-v3-turbo,europe,159,1,2,162,0.01851851851851849
GPT-4o mini Transcribe,including,426,1,7,434,0.018433179723502335
whisper-small,excellent,54,0,1,55,0.018181818181818188
whisper-small,pl,54,1,0,55,0.018181818181818188
whisper-large-v3-turbo,commercial,162,3,0,165,0.018181818181818188
GPT-4o mini Transcribe,leverage,217,3,1,221,0.018099547511312264
whisper-small,activity,109,1,1,111,0.018018018018018056
whisper-large-v3-turbo,currency,164,3,0,167,0.017964071856287456
GPT-4o mini Transcribe,commercial,165,3,0,168,0.017857142857142905
GPT-4o mini Transcribe,track,55,0,1,56,0.017857142857142905
GPT-4o mini Transcribe,outlook,222,1,3,226,0.017699115044247815
GPT-4o mini Transcribe,constant,167,3,0,170,0.01764705882352946
whisper-small,track,56,0,1,57,0.01754385964912286
whisper-large-v3-turbo,anticipate,56,1,0,57,0.01754385964912286
whisper-small,anticipate,56,1,0,57,0.01754385964912286
GPT-4o mini Transcribe,portfolio,168,3,0,171,0.01754385964912286
GPT-4o mini Transcribe,anticipate,56,1,0,57,0.01754385964912286
whisper-large-v3-turbo,forward,169,3,0,172,0.01744186046511631
GPT-4o mini Transcribe,here,338,0,6,344,0.01744186046511631
whisper-large-v3-turbo,constant,170,3,0,173,0.017341040462427793
GPT-4o mini Transcribe,direct,57,0,1,58,0.017241379310344862
GPT-4o mini Transcribe,may,173,0,3,176,0.017045454545454586
whisper-large-v3-turbo,assume,58,1,0,59,0.016949152542372836
whisper-large-v3-turbo,main,235,0,4,239,0.01673640167364021
GPT-4o mini Transcribe,run,59,0,1,60,0.01666666666666672
whisper-large-v3-turbo,small,59,0,1,60,0.01666666666666672
GPT-4o mini Transcribe,im,177,0,3,180,0.01666666666666672
whisper-small,run,60,0,1,61,0.016393442622950838
whisper-large-v3-turbo,although,60,0,1,61,0.016393442622950838
GPT-4o mini Transcribe,annualized,60,0,1,61,0.016393442622950838
whisper-large-v3-turbo,run,60,1,0,61,0.016393442622950838
whisper-small,couple,61,1,0,62,0.016129032258064502
GPT-4o mini Transcribe,administrative,61,1,0,62,0.016129032258064502
whisper-large-v3-turbo,couple,61,1,0,62,0.016129032258064502
whisper-small,assume,61,1,0,62,0.016129032258064502
GPT-4o mini Transcribe,couple,61,1,0,62,0.016129032258064502
whisper-small,administrative,61,1,0,62,0.016129032258064502
whisper-large-v3-turbo,pesos,369,6,0,375,0.016000000000000014
whisper-large-v3-turbo,opportunity,62,0,1,63,0.015873015873015928
whisper-large-v3-turbo,once,62,0,1,63,0.015873015873015928
GPT-4o mini Transcribe,july,62,0,1,63,0.015873015873015928
GPT-4o mini Transcribe,back,436,3,4,443,0.015801354401805856
whisper-small,lastly,63,1,0,64,0.015625
whisper-small,drive,63,0,1,64,0.015625
GPT-4o mini Transcribe,pesos,378,6,0,384,0.015625
GPT-4o mini Transcribe,initiatives,63,0,1,64,0.015625
whisper-large-v3-turbo,supply,64,1,0,65,0.01538461538461533
whisper-large-v3-turbo,hope,64,0,1,65,0.01538461538461533
GPT-4o mini Transcribe,profitability,193,3,0,196,0.015306122448979553
whisper-small,minus,195,0,3,198,0.015151515151515138
GPT-4o mini Transcribe,sale,66,0,1,67,0.014925373134328401
GPT-4o mini Transcribe,numbers,200,0,3,203,0.014778325123152691
whisper-large-v3-turbo,online,67,0,1,68,0.014705882352941124
GPT-4o mini Transcribe,online,67,0,1,68,0.014705882352941124
whisper-small,provision,67,0,1,68,0.014705882352941124
whisper-small,raised,67,1,0,68,0.014705882352941124
whisper-small,online,67,1,0,68,0.014705882352941124
whisper-small,supply,67,1,0,68,0.014705882352941124
GPT-4o mini Transcribe,supply,67,1,0,68,0.014705882352941124
GPT-4o mini Transcribe,proceeds,68,1,0,69,0.01449275362318836
whisper-large-v3-turbo,guess,69,1,0,70,0.014285714285714235
GPT-4o mini Transcribe,remaining,70,0,1,71,0.014084507042253502
GPT-4o mini Transcribe,partners,70,0,1,71,0.014084507042253502
whisper-small,reasons,71,1,0,72,0.01388888888888884
whisper-small,does,71,1,0,72,0.01388888888888884
whisper-large-v3-turbo,proceeds,71,1,0,72,0.01388888888888884
whisper-small,sga,71,0,1,72,0.01388888888888884
GPT-4o mini Transcribe,across,214,0,3,217,0.01382488479262678
whisper-small,north,72,0,1,73,0.013698630136986356
GPT-4o mini Transcribe,north,72,0,1,73,0.013698630136986356
whisper-large-v3-turbo,north,72,1,0,73,0.013698630136986356
whisper-small,gave,73,0,1,74,0.013513513513513487
whisper-large-v3-turbo,sustainable,73,0,1,74,0.013513513513513487
GPT-4o mini Transcribe,other,589,0,8,597,0.01340033500837523
whisper-large-v3-turbo,remaining,74,0,1,75,0.013333333333333308
whisper-small,double,223,0,3,226,0.013274336283185861
GPT-4o mini Transcribe,double,225,0,3,228,0.013157894736842146
whisper-large-v3-turbo,double,226,0,3,229,0.013100436681222738
whisper-small,saw,228,0,3,231,0.012987012987012991
GPT-4o mini Transcribe,europe,154,0,2,156,0.012820512820512775
whisper-large-v3-turbo,trailing,77,1,0,78,0.012820512820512775
GPT-4o mini Transcribe,segments,157,0,2,159,0.012578616352201255
whisper-small,generating,79,0,1,80,0.012499999999999956
whisper-large-v3-turbo,generating,79,1,0,80,0.012499999999999956
whisper-small,declined,237,0,3,240,0.012499999999999956
whisper-small,flows,80,1,0,81,0.012345679012345734
GPT-4o mini Transcribe,opportunities,80,1,0,81,0.012345679012345734
GPT-4o mini Transcribe,flows,80,0,1,81,0.012345679012345734
whisper-large-v3-turbo,flows,80,0,1,81,0.012345679012345734
GPT-4o mini Transcribe,gas,161,2,0,163,0.012269938650306789
whisper-large-v3-turbo,service,242,0,3,245,0.01224489795918371
GPT-4o mini Transcribe,service,245,0,3,248,0.012096774193548376
whisper-large-v3-turbo,targets,82,0,1,83,0.012048192771084376
whisper-large-v3-turbo,together,82,0,1,83,0.012048192771084376
GPT-4o mini Transcribe,margins,250,0,3,253,0.011857707509881465
GPT-4o mini Transcribe,trend,89,0,1,90,0.011111111111111072
GPT-4o mini Transcribe,best,89,1,0,90,0.011111111111111072
GPT-4o mini Transcribe,tier,90,1,0,91,0.01098901098901095
whisper-large-v3-turbo,combined,92,1,0,93,0.010752688172043001
GPT-4o mini Transcribe,closed,93,0,1,94,0.010638297872340385
GPT-4o mini Transcribe,covid,378,4,0,382,0.010471204188481686
GPT-4o mini Transcribe,resulted,97,0,1,98,0.010204081632653073
GPT-4o mini Transcribe,solutions,97,0,1,98,0.010204081632653073
GPT-4o mini Transcribe,focus,102,0,1,103,0.009708737864077666
GPT-4o mini Transcribe,starting,106,0,1,107,0.009345794392523366
whisper-large-v3-turbo,my,215,1,1,217,0.009216589861751112
whisper-large-v3-turbo,areas,112,0,1,113,0.008849557522123908
whisper-large-v3-turbo,set,113,1,0,114,0.00877192982456143
whisper-large-v3-turbo,short,114,0,1,115,0.008695652173912993
GPT-4o mini Transcribe,short,117,0,1,118,0.008474576271186418
whisper-large-v3-turbo,sequentially,118,1,0,119,0.008403361344537785
whisper-small,sequentially,118,1,0,119,0.008403361344537785
whisper-large-v3-turbo,remained,129,0,1,130,0.007692307692307665
GPT-4o mini Transcribe,remained,132,0,1,133,0.007518796992481258
whisper-large-v3-turbo,global,138,0,1,139,0.007194244604316502
whisper-small,rise,147,1,0,148,0.006756756756756799
GPT-4o mini Transcribe,continues,154,0,1,155,0.006451612903225823
GPT-4o mini Transcribe,currency,163,0,1,164,0.0060975609756097615
whisper-small,forward,170,0,1,171,0.005847953216374324
whisper-small,organically,170,1,0,171,0.005847953216374324
whisper-large-v3-turbo,turn,192,0,1,193,0.005181347150259086
GPT-4o mini Transcribe,off,193,0,1,194,0.005154639175257714
GPT-4o mini Transcribe,my,208,0,1,209,0.004784688995215336
